NTD ID,Agency Name,Reporter Type,Reporting Module,CA: Cash and Cash Equivalents,CA: Accounts Receivable,CA: Inventory,CA: Prepaid Expenses,CA: Current Investments and Current Portions of Long-Term Investments,CA: Other Current Assets,Total Current Assets,NCA: Capital Assets,NCA: Intangible Assets,NCA: Capital Leases Receivables,NCA: Special Funds,NCA: Work in Progress,NCA: Investments,NCA: Other Noncurrent Assets,Total Noncurrent Assets,Total Assets,Deferred Outflows of Resources,CL: Current Accounts Payable,CL: Short-Term Debt and Current Portions of Long-Term Debt,CL: Accrued Liabilities,CL: Other Current Liabilities,Total Current Liabilities,NCL: Long-Term Debt,NCL: Noncurrent Accounts Payable,NCL: Capital Lease Obligations,NCL: Long-Term Pension Liabilities,NCL: Estimated Liabilities,NCL: Other Noncurrent Liabilities,Total Noncurrent Liabilities,Total Liabilities,Deferred Inflows of Resources,Net Position
2,Spokane Transit Authority,Full Reporter,Urban,99267885,23711631,1666503,490594,0,0,125136613,84807614,3551521,0,0,18746931,0,0,107106066,232242679,4333363,5280342,0,7534695,1466242,14281279,0,0,0,14096584,0,0,14096584,28377863,7646752,200551427
3,Pierce County Transportation Benefit Area Authority,Full Reporter,Urban,3157421,534935,4107941,533315,41008254,39709212,89051078,92129946,0,0,64631580,30609175,0,0,187370701,276421779,8141111,5119350,0,0,9847058,14966408,0,0,0,25740928,9010616,0,34751544,49717952,14982128,219862810
7,Lane Transit District,Full Reporter,Urban,14897748,22337080,1468097,213365,0,0,38916290,162932962,0,0,0,0,0,0,162932962,201849252,6301745,3322473,0,3870411,702613,7895497,0,0,0,23522029,0,11660678,35182707,43078204,1181933,163890860
8,Tri-County Metropolitan Transportation District of Oregon,Full Reporter,Urban,116895742,84961270,45541320,10185144,0,96815313,354398789,2790166627,0,0,368969211,224083556,0,31014311,3414233705,3768632494,54296235,54421745,47206108,36829573,48206951,186664377,730800157,4010394,63151047,873872863,21583880,0,1693418341,1880082718,111088481,1831757530
11,Valley Regional Transit,Full Reporter,Urban,751430,918702,435882,67157,0,0,2173171,30039500,0,0,0,999142,0,0,31038642,33211813,152237,821220,0,719919,421316,1962455,0,0,0,518297,0,0,518297,2480752,243696,30639602
18,Ben Franklin Transit,Full Reporter,Urban,41493328,16395950,505109,277328,0,0,58671715,33756685,0,0,0,2622940,0,0,36379625,95051340,2224498,1587197,0,1620971,0,3208168,0,0,0,6460375,0,4419180,10879555,14087723,3632510,79555605
19,Intercity Transit,Full Reporter,Urban,79779111,15335288,1109754,258617,0,0,96482770,43619736,0,0,0,14820406,0,0,58440142,154922912,3899217,1881471,0,1305153,368818,3555442,0,0,0,17014815,0,2180097,19194912,22750354,5069138,131002637
20,Kitsap Transit,Full Reporter,Urban,10676935,17420149,1944259,447220,32379391,0,62867954,125424354,358013,0,12320593,28823663,0,141863,167068486,229936440,2622771,5543798,5123548,1658092,0,12325438,39451031,0,0,7279103,0,1859598,48589732,60915170,4482759,167161282
21,Whatcom Transportation Authority,Full Reporter,Urban,30305608,5718930,1202054,280230,0,0,37506822,39888112,0,0,0,1379575,0,0,41267687,78774509,2095589,742292,0,3048723,8333,3799348,0,0,0,6272368,0,124550,6396918,10196266,3520430,67153402
24,Clark County Public Transportation Benefit Area Authority,Full Reporter,Urban,4782536,12255838,2141766,570653,5224644,0,24975437,126433794,4384935,0,71252250,4604405,0,134308,206809692,231785129,3681074,1636864,0,5134821,828885,7600570,0,0,0,10425213,500000,587096,11512309,19112879,5955146,210398178
25,Salem Area Mass Transit District,Full Reporter,Urban,2422091,14559671,897124,624537,0,6630,18510053,27967365,0,0,0,4828265,10227532,0,43023162,61533215,2682941,1601387,0,2554837,30448,4186672,0,0,0,9595157,0,0,9595157,13781829,703079,49731248
29,Snohomish County Public Transportation Benefit Area Corporation,Full Reporter,Urban,155905203,58292632,1472975,331632,0,0,216002442,243012841,5074666,0,1853040,11178821,81995797,0,343115165,559117607,11220836,6257011,1254577,11535718,3073104,22120410,9275962,0,0,34345867,3073946,0,46695775,68816185,12066509,489455749
34,Rogue Valley Transportation District,Full Reporter,Urban,9848757,5869159,432844,69492,0,0,16220252,11814098,0,0,0,0,0,0,11814098,28034350,0,588031,0,562195,0,1150226,436151,0,0,0,0,0,436151,1586377,0,0
40,Central Puget Sound Regional Transit Authority,Full Reporter,Urban,160857406,454023136,21857936,10023828,1200149549,24569189,1871481044,5343934198,1048021997,64875828,233289592,5838853458,647564940,1267361,13177807374,15049288418,33025206,423689734,42915000,57478901,19152143,543235778,2443728792,0,64875828,0,0,6234402,2514839022,3058074800,0,0
43,Link Transit,Full Reporter,Urban,668853,2887390,351707,21006,11225533,0,15154489,29027961,0,0,51470,88269,0,0,29167700,44322189,838487,465228,0,763411,0,1228639,0,0,0,2601448,0,50000,2651448,3880087,1553420,39727169
44,Skagit Transit,Full Reporter,Urban,11383342,2528140,385216,0,0,0,14296698,25396114,390167,0,0,1855902,0,0,27642183,41938881,0,79413,0,625670,5325,710408,0,0,0,0,0,282029,282029,992437,0,0
10001,Rhode Island Public Transit Authority,Full Reporter,Urban,8610920,13927071,2070868,169654,1681036,0,26459549,106489903,0,0,3766911,13167728,2930630,0,126355172,152814721,19662178,18347093,2467992,8956636,153402,29925123,10095000,0,0,139186893,12293632,0,161575525,191500648,4296036,-23319785
10003,Massachusetts Bay Transportation Authority,Full Reporter,Urban,178807350,203185231,62885602,3725565,35703095,253477869,737784712,10607503423,0,27983739,0,0,0,785598034,11421085196,12158869908,814295123,317204292,385530000,232155516,0,934889808,5107984703,0,65773968,3910844008,0,131732549,9216335228,10151225036,413731302,2408208693
10004,Brockton Area Transit Authority,Full Reporter,Urban,1991686,5755035,0,0,0,199881,7946602,22680337,0,0,0,0,0,1174333,23854670,31801272,415367,695759,0,297113,1234394,2227266,6300000,0,0,871984,0,994204,8166188,10393454,93878,21729307
10005,Lowell Regional Transit Authority,Full Reporter,Urban,604341,4118074,0,73952,0,503641,5300008,36620221,0,0,0,0,0,1642781,38263002,43563010,70124,956584,5300000,97698,0,6354282,0,0,0,1336828,0,103626,1440454,7794736,27958,35810440
10006,Southeastern Regional Transit Authority,Full Reporter,Urban,414092,7887373,1217412,362006,0,0,9880883,20679643,0,0,0,1598101,0,0,22277744,32158627,4008712,1065473,4254041,324681,0,5644195,0,0,0,6656136,589958,134942,7381036,13025231,3517802,19624306
10007,Berkshire Regional Transit Authority,Full Reporter,Urban,1119729,5017816,0,52768,0,797816,6988129,13066313,0,0,0,0,0,0,13066313,20054442,56777,935666,4750000,127460,169130,5982256,0,0,0,685283,0,0,685283,6667539,0,0
10008,Pioneer Valley Transit Authority,Full Reporter,Urban,3165460,22278155,0,590451,3981884,0,30015950,118846735,0,0,490702,0,0,0,119337437,149353387,2686681,7132244,13100000,616885,3241313,24090442,0,0,0,45311823,0,0,45311823,69402265,5400017,77237786
10013,Merrimack Valley Regional Transit Authority,Full Reporter,Urban,2516317,7345778,0,130216,0,0,9992311,59876066,0,0,269685,0,0,579208,60724959,70717270,524276,2090116,130216,49271,0,2269603,8979208,0,0,863513,0,98758,9941479,12211082,0,0
10014,Worcester Regional Transit Authority,Full Reporter,Urban,495460,9673241,408021,16947,0,0,10593669,110235308,210539,0,0,0,0,0,110445847,121039516,1488699,1592987,11300000,100205,48080,13041272,3300000,0,0,12531909,8650422,0,24482331,37523603,579470,84425142
10016,Greater Portland Transit District,Full Reporter,Urban,1081791,811940,380777,2765,0,0,2277273,13569538,0,0,0,130458,0,0,13699996,15977269,22114,257613,240746,334395,0,832754,1293511,0,0,533233,6536,10000,1843280,2676034,36752,13286597
10017,Greater Hartford Transit District,Full Reporter,Urban,84702,2590936,0,135557,1465801,0,4276996,37137851,0,0,0,0,5863205,0,43001056,47278052,0,5534379,0,1642221,482249,7658849,0,0,0,618444,0,0,618444,8277293,0,0
10040,Southeast Area Transit District,Full Reporter,Urban,118750,385712,273437,130622,0,0,908521,8956277,0,0,0,0,0,0,8956277,9864798,0,277955,110304,91681,0,479940,0,0,0,0,0,0,0,479940,0,9384858
10042,Valley Transit District,Full Reporter,Urban,6052,99487,0,9651,0,33722,148912,5420610,0,0,0,0,0,0,5420610,5569522,0,39540,0,60515,22381,122436,183870,0,0,0,0,0,183870,306306,0,0
10049,Greater New Haven Transit District,Full Reporter,Urban,614685,1411555,44789,93356,0,0,2164385,7550947,0,0,0,0,0,0,7550947,9715332,0,523470,0,445352,0,968822,0,0,0,0,0,0,0,968822,25574,0
10050,Greater Bridgeport Transit Authority,Full Reporter,Urban,3795484,1619142,984827,19431,0,0,6418884,34226516,0,0,0,247096,0,0,34473612,40892496,170941,797883,0,5182048,240588,6220519,0,0,0,12239726,269411,0,12509137,18729656,855323,21478458
10051,Housatonic Area Regional Transit ,Full Reporter,Urban,1002415,1321799,75460,3170,0,0,2402844,29173687,0,0,0,0,1680630,0,30854317,33257161,0,239853,105674,100772,0,446299,23712,0,0,0,0,0,23712,470011,0,0
10053,Cape Ann Transportation Authority,Full Reporter,Urban,231282,4657396,0,37641,0,293674,5219993,7248774,0,0,0,0,0,0,7248774,12468767,0,2802259,0,99951,0,2902210,2300000,0,0,0,0,0,2300000,5202210,0,0
10057,Norwalk Transit District,Full Reporter,Urban,135884,1034470,527515,14825,0,0,1712694,23504963,0,0,0,195497,0,0,23700460,25413154,0,331495,2684211,741901,9096,3766703,0,0,0,0,193625,0,193625,3960328,0,0
10061,Montachusett Regional Transit Authority,Full Reporter,Urban,5845520,31292779,0,0,0,574820,37713119,46220017,0,0,0,0,0,0,46220017,83933136,0,28626482,19053333,412018,483762,48575595,316670,0,0,0,0,0,316670,48892265,0,0
10064,Greater Attleboro-Taunton Regional Transit Authority,Full Reporter,Urban,573057,18168530,265713,0,0,0,19007300,26651021,0,0,0,0,0,4345997,30997018,50004318,490436,10321619,7800000,202879,300894,18625392,0,0,0,5706763,0,424785,6131548,24756940,590211,25147603
10066,Green Mountain Transit Authority,Full Reporter,Urban,1098224,4929457,721817,318667,0,0,7068165,60260979,0,0,0,196186,0,0,60457165,67525330,419331,2739431,0,1224050,17498,3980979,0,0,0,0,0,0,0,3980979,0,0
10086,Cooperative Alliance for Seacoast Transportation,Full Reporter,Urban,868437,496923,92033,77267,0,0,1534660,4090867,0,0,0,0,0,0,4090867,5625527,0,157347,0,388814,50791,596952,0,0,0,0,0,0,0,596952,0,0
10088,Casco Bay Island Transit District,Full Reporter,Urban,4667562,332798,103150,23358,0,0,5126868,11107438,0,0,1727990,1093733,0,0,13929161,19056029,0,151715,0,518909,48973,719597,0,0,0,0,0,1692210,1692210,2411807,0,0
10098,"Western Maine Transportation Services, Inc.",Full Reporter,Urban,227716,554651,379821,201302,0,0,1363490,1583890,0,0,0,0,0,0,1583890,2947380,0,83897,668418,150843,0,903158,715617,0,0,0,0,0,715617,1618775,0,0
10105,Cape Cod Regional Transit Authority,Full Reporter,Urban,287460,5131511,0,0,0,937022,6355993,29693868,451138,0,0,0,0,4246968,34391974,40747967,938942,3203454,103667,365173,0,3672294,7600000,200979,0,2336890,0,1547763,11685632,15357926,353598,25975385
10107,Milford Transit District,Full Reporter,Urban,46077,317470,0,0,0,0,363547,4349571,0,0,0,0,0,0,4349571,4713118,0,142195,0,58701,5000,205896,4324571,0,0,0,0,155902,4480473,4686369,0,0
10115,Northern New England Passenger Rail Authority,Full Reporter,Urban,2180601,3308819,65225,52617,0,0,5607262,14738241,0,0,0,298620,0,377761,15414622,21021884,298620,3302405,0,44594,0,3346999,0,0,0,1277445,0,0,1277445,4624444,154259,16541801
10118,MetroWest Regional Transit Authority,Full Reporter,Urban,518885,10949834,0,524062,0,0,11992781,21504990,0,0,1018206,0,0,0,22523196,34515977,107000,780059,1400000,314579,0,2494638,0,1030580,0,2120000,0,9485769,12636349,15130987,0,0
10128,Connecticut Department of Transportation- CTTransit Waterbury- NET,Full Reporter,Urban,516774,1844065,762267,243450,0,0,3366556,0,0,0,120056,0,0,895792,1015848,4382404,0,131643,1065991,834313,0,2031947,0,0,0,0,0,206800,206800,2238747,0,0
10183,"Woods Hole, Martha's Vineyard and Nantucket Steamship Authority",Full Reporter,Urban,8847936,2349868,585825,4461003,2676411,78753,18999796,171503357,0,0,22165378,37268268,0,0,230937003,249936799,5453757,5137192,8640774,4238026,5736840,23752832,73475822,0,0,29153089,0,0,102628911,126381743,2049416,126959397
20002,Capital District Transportation Authority,Full Reporter,Urban,9993516,14546802,0,0,0,4001812,28542130,121138986,0,0,19364099,0,0,0,140503085,169045215,2608902,12928725,0,0,3593823,16522548,0,0,4723962,90160188,10882600,735846,106502596,123025144,4407177,44221796
20004,Niagara Frontier Transportation Authority,Full Reporter,Urban,12418000,39098000,5115000,254000,0,0,56885000,297532000,0,0,2957000,0,25000,0,300514000,357399000,23161000,14162000,3957000,0,710000,18829000,15700000,0,0,431893000,39333000,2972000,489898000,508727000,4266000,-132433000
20008,MTA New York City Transit,Full Reporter,Urban,224338169,714975626,315670907,38464720,0,0,1293449422,41297459284,0,0,730347105,4025831757,0,0,46053638146,47347087568,2323081638,476289647,9707669,1127302401,360688340,1973988057,70428768,0,179170927,18557979996,3058922234,583681,21867085606,23841073663,1854601003,23974494540
20018,Central New York Regional Transportation Authority,Full Reporter,Urban,4627552,5149457,4294633,4724071,0,0,18795713,95448192,0,0,0,11000,0,18214814,113674006,132469719,5677836,2999254,0,2839902,987397,6826553,0,0,0,255143514,4505902,21475148,281124564,287951117,2085864,-151889426
20075,Port Authority Transit Corporation,Full Reporter,Urban,2757240,2429341,5993777,938644,2790058,0,14909060,0,0,0,142500,0,0,0,142500,15051560,13738816,3130757,0,2194784,9065610,14391151,0,0,0,23921924,13962821,281462000,319346745,333737896,561732,-305509252
20078,"Metro-North Commuter Railroad Company, dba: MTA Metro-North Railroad",Full Reporter,Urban,36768422,92504414,140988837,28309070,7731443,8746543,315048729,3788925278,0,0,0,1687984410,0,4685422,5481595110,5796643839,425571944,65995358,0,353497393,26358391,445851142,0,0,13435457,2047230582,55204634,55724192,2171594865,2617446007,144960650,3459809126
20080,New Jersey Transit Corporation,Full Reporter,Urban,132822259,53769479,129135771,0,8307106,269529964,593564579,5005059170,0,0,330405954,1221159272,0,193405,6556817801,7150382380,320270347,166417333,250822103,134298913,107465361,659003710,721811871,0,212035641,1981215664,241115703,72982595,3229161474,3888165184,125276701,3457210842
20098,Port Authority Trans-Hudson Corporation,Full Reporter,Urban,170304091,719892026,44905383,124507128,1250152257,60905201,2370666086,38002680951,0,0,0,1014303142,2692125451,4748103223,46457212767,48827878853,419288366,1316913488,1045116438,959328385,8866427,3330224738,24421178734,2383931095,0,1538117181,0,1055910604,29399137614,32729362352,358602081,16159202786
20099,Staten Island Rapid Transit Operating Authority,Full Reporter,Urban,152677,54635425,1927281,540375,0,0,57255758,257400804,0,0,0,173689056,0,0,431089860,488345618,35804684,2017171,0,8569236,40875044,51461451,0,0,0,109210020,18935344,0,128145364,179606815,7623857,336919630
20100,MTA Long Island Rail Road,Full Reporter,Urban,6959062,204422754,149730197,33494759,0,0,394606772,5234383319,0,0,0,2647145047,0,0,7881528366,8276135138,558738413,189160720,3406263,179229216,11479405,383275604,25325947,0,0,3528796712,131003336,85769806,3770895801,4154171405,264087622,4416614524
20113,Regional Transit Service - Monroe County,Full Reporter,Urban,18557784,4667051,407982,705341,15058457,0,39396615,129556228,0,0,0,0,13871229,369944,143797401,183194016,4869967,4566966,0,4143071,10062532,18772569,0,0,0,7311458,113315814,643521,121270793,140043362,5610830,42409791
20188,MTA Bus Company,Full Reporter,Urban,1061748,42118185,14933139,5172153,0,47761771,111046996,368873289,0,0,0,0,0,182588382,551461671,662508667,0,6065735,61001004,75662018,52572341,195301098,0,0,0,348357431,1088306192,0,1436663623,1631964721,0,0
30001,Kanawha Valley Regional Transportation Authority,Full Reporter,Urban,14466798,351867,455600,0,0,1305701,16579966,10919160,0,0,0,0,503573,0,11422733,28002699,2461632,27960,0,620728,11066414,11715102,0,0,0,0,0,0,0,11715102,1576486,17172743
30002,The Tri-State Transit Authority,Full Reporter,Urban,8043168,491567,285026,36601,0,0,8856362,32271886,0,0,0,0,0,0,32271886,41128248,450514,97165,0,986373,0,1083538,0,0,0,0,0,0,0,1083538,362593,40132631
30006,Greater Richmond Transit Company,Full Reporter,Urban,16943632,11285591,857127,1218701,0,0,30305051,97914632,908230,0,0,0,0,0,98822862,129127913,12054783,12258902,0,542829,375015,13176746,0,0,0,47705065,385675,2052712,50143452,63320198,6801485,71061013
30007,Greater Roanoke Transit Company,Full Reporter,Urban,126486,3911646,499667,23512,0,0,4561311,13886034,0,0,0,0,0,0,13886034,18447345,0,2644669,0,424462,1038779,4107910,0,0,0,0,0,0,0,4107910,0,0
30008,Greater Lynchburg Transit Company,Full Reporter,Urban,921576,95857,314732,33765,0,0,1365930,37119500,0,0,0,0,0,0,37119500,38485430,66454,292816,0,166660,65550,525026,0,103970,0,0,0,552260,656230,1181256,1126,37369502
30010,Lehigh and Northampton Transportation Authority,Full Reporter,Urban,2617758,3214370,564535,14856286,0,0,21252949,41767152,0,0,0,0,0,0,41767152,63020101,2665538,2799626,7645,1523542,2180479,6511292,0,0,0,15485218,0,14660593,30145811,36657103,459624,28568912
30011,Altoona Metro Transit,Full Reporter,Urban,1036211,577772,193546,112488,2250063,0,4170080,14162295,0,0,0,0,1732000,0,15894295,20064375,2937,330771,0,0,290295,621066,0,0,0,78703,0,4982128,5060831,5681897,109617,14275798
30012,Cambria County Transit Authority,Full Reporter,Urban,6861226,896081,468273,204527,0,0,8430107,35988735,0,0,0,574576,0,0,36563311,44993418,285720,511308,0,424281,0,935589,0,0,0,1097891,0,6972099,8069990,9005579,198809,36074750
30013,Erie Metropolitan Transit Authority,Full Reporter,Urban,7850511,4109948,255433,374588,0,0,12590480,74452800,0,0,0,0,0,0,74452800,87043280,1549291,3829787,0,1382258,6244029,11456074,0,0,0,2030643,0,4756816,6787459,18243533,1279479,69069559
30014,Cumberland Dauphin-Harrisburg Transit Authority,Full Reporter,Urban,1080175,2188530,401629,245262,0,0,3915596,18550412,0,0,0,0,0,75916,18626328,22541924,2407152,817715,0,1000203,1666542,3484460,0,0,0,0,447969,423496,871465,4355925,935288,19657863
30015,Luzerne County Transportation Authority,Full Reporter,Urban,2827903,1618782,425021,320943,0,0,5192649,9308074,0,0,0,0,0,0,9308074,14500723,198821,139616,0,626390,11269417,12035423,0,0,0,525252,0,0,525252,12560675,598841,1540028
30019,Southeastern Pennsylvania Transportation Authority,Full Reporter,Urban,22335955,201172782,90825025,22252660,59498099,254504240,650588761,4206426572,0,0,41471640,460468866,0,3984510,4712351588,5362940349,222146236,131118878,179997113,106899116,328885145,746900252,530433228,0,25362837,909803894,109702863,1184123986,2759426808,3506327060,639124146,1439635379
30022,Port Authority of Allegheny County,Full Reporter,Urban,136523360,35761045,15400036,620781,0,0,188305222,1297015031,0,0,0,0,0,56038814,1353053845,1541359067,177585791,15481019,13140000,24597035,165671600,218889654,159491049,0,0,421374849,0,627936852,1208802750,1427692404,68139828,223112626
30023,Beaver County Transit Authority,Full Reporter,Urban,3320451,2109353,219350,198120,0,0,5847274,24523647,0,0,0,456431,0,0,24980078,30827352,0,292376,0,303541,0,595917,0,0,0,0,12563,0,12563,608480,3982095,0
30025,County of Lackawanna Transit System,Full Reporter,Urban,2416724,120113,135824,282132,71362,2234367,5260522,25907330,0,0,0,0,0,0,25907330,31167852,692932,386925,0,1584866,4463615,6435406,0,0,0,2894888,0,588406,3483294,9918700,0,0
30027,Central Pennsylvania Transportation Authority,Full Reporter,Urban,5238698,6783735,424602,493378,0,0,12940413,42735879,0,0,0,746686,0,0,43482565,56422978,0,2592614,0,922423,8012642,11527679,0,0,0,0,0,0,0,11527679,0,0
30030,Washington Metropolitan Area Transit Authority,Full Reporter,Urban,240582368,167934369,110878711,0,47869070,0,567264518,12648292980,0,0,0,0,56229288,0,12704522268,13271786786,408378388,416726079,75550000,403248775,69863462,965388316,1071603611,10366343,0,2957789735,149775657,12543789,4202079135,5167467451,409359349,8103338374
30035,Ohio Valley Regional Transportation Authority,Full Reporter,Urban,2719534,1572981,71419,74562,714051,22654,5175201,3446179,0,0,681660,0,0,0,4127839,9303040,285370,117022,52818,624342,4320,798502,0,0,148073,369141,0,321265,838479,1636981,277518,7673911
30045,"JAUNT, Inc.",Full Reporter,Urban,1124517,1003309,0,202631,0,0,2330457,6041945,0,0,0,1269831,0,0,7311776,9642233,0,0,0,0,688086,688086,0,0,0,0,0,0,0,688086,0,0
30054,Centre Area Transportation Authority,Full Reporter,Urban,3102612,7768884,566079,114696,0,0,11552271,57100472,0,0,0,0,0,0,57100472,68652743,0,1508806,2550000,723964,6718602,11501372,0,0,0,0,0,0,0,11501372,0,0
30061,Mid Mon Valley Transit Authority,Full Reporter,Urban,754735,127192,2500,0,0,0,884427,21106415,130840,0,0,0,0,0,21237255,22121682,0,0,0,0,1116533,1116533,0,0,0,0,0,0,0,1116533,0,0
30070,Potomac and Rappahannock Transportation Commission,Full Reporter,Urban,12992209,37496609,0,424216,0,19467692,70380726,70358325,0,0,0,0,0,231536,70589861,140970587,294876,7012282,245000,521595,17606441,25385318,958829,0,0,277148,0,480916,1716893,27102211,151452,114011800
30073,Virginia Railway Express,Full Reporter,Urban,75278280,30954560,2846838,162891,0,11124,109253693,341997027,0,0,13677765,0,0,320509,355995301,465248994,840915,5116908,3730497,3756446,1877011,14480862,47594689,0,8541916,431852,0,623873,57192330,71673192,214069,394202648
30075,Delaware Transit Corporation,Full Reporter,Urban,17516478,2016626,4423132,94216,0,0,24050452,130686513,0,0,0,0,15594641,0,146281154,170331606,14079577,6255449,0,6482852,0,12738301,0,2294897,0,164518708,0,7304064,174117669,186855970,41667009,-44111796
30076,Williamsburg Area Transit Authority,Full Reporter,Urban,1614162,3891162,0,0,0,0,5505324,6049492,0,0,0,2771628,0,71374,8892494,14397818,0,3227727,0,0,195695,3423422,0,0,0,0,0,0,0,3423422,1777,0
30083,Transportation District Commission of Hampton Roads,Full Reporter,Urban,11631786,27173371,7159783,1983796,399325,0,48348061,255898037,53418,0,0,6300380,1000,0,262252835,310600896,9748805,4579337,16605091,8633462,11054313,40872203,0,0,895943,10971281,0,5183598,17050822,57923025,4445273,257981403
30095,County of Lebanon Transit Authority,Full Reporter,Urban,2622856,144172,102555,2433,0,0,2872016,6832784,0,0,0,0,0,0,6832784,9704800,0,123870,0,109985,2683751,2917606,0,0,0,0,0,0,0,2917606,0,0
30096,The Tri-County Council for the Lower Eastern Shore of Maryland,Full Reporter,Urban,889334,0,0,0,0,0,889334,18269322,0,0,0,0,0,0,18269322,19158656,0,0,0,0,149610,149610,0,0,0,0,0,0,0,149610,0,0
30111,Washington County Transportation Authority,Full Reporter,Urban,1379747,761876,0,17236,0,106,2158965,7012937,0,0,0,0,0,0,7012937,9171902,0,452761,0,16095,0,468856,0,0,0,0,0,1300025,1300025,1768881,0,0
30137,Monroe County Transportation  Authority,Full Reporter,Urban,1082911,1443501,121208,60056,0,0,2707676,8175413,0,0,0,0,0,0,8175413,10883089,0,1930316,0,0,0,1930316,0,0,0,0,0,0,0,1930316,0,0
30202,South Central Transit Authority,Full Reporter,Urban,17774052,5329827,830896,131875,0,903963,24970613,85693142,0,0,0,0,0,378654,86071796,111042409,1271693,1805176,0,1231785,18088494,21125455,0,0,0,4285852,0,0,4285852,25411307,1277774,85625021
40004,Metropolitan Transit Authority,Full Reporter,Urban,4576832,9767032,2737465,606914,0,0,17688243,139261106,0,0,1330473,32766665,350000,0,173708244,191396487,10145436,4257520,6500000,6229430,703338,17690288,0,0,0,82422175,0,8423109,90845284,108535572,3965635,89040716
40006,Cape Fear Public Transportation Authority,Full Reporter,Urban,140196,2737850,174509,0,0,0,3052555,23858411,0,0,0,3307196,0,0,27165607,30218162,305884,2617490,0,228216,0,2845706,0,0,0,377204,0,0,377204,3222910,11917,27289219
40012,City of Winston Salem,Full Reporter,Urban,1262048,5901861,307446,0,0,0,7471355,26137091,0,0,0,0,0,0,26137091,33608446,0,2243353,0,0,77985,2321338,0,0,0,0,0,0,0,2321338,0,0
40014,Ms Coast Transportation Authority,Full Reporter,Urban,1963862,849654,2315211,146612,0,0,5275339,22818416,0,0,0,1559563,0,0,24377979,29653318,0,661532,0,260240,0,921772,0,0,0,0,0,0,0,921772,0,0
40017,Lexington Transit Authority,Full Reporter,Urban,13219829,13018726,646135,27460,0,0,26912150,25735833,0,0,0,0,0,0,25735833,52647983,2322984,856974,0,637177,0,1494151,5844012,0,0,0,0,0,5844012,7338163,2911112,44721692
40018,Transit Authority of River City,Full Reporter,Urban,15415246,6267438,1289715,800318,0,0,23772717,84709304,0,0,0,0,31000,0,84740304,108513021,23183253,9664430,6181202,5697381,984463,22527476,398347,0,0,81695201,1664335,23202276,106960159,129487635,6705913,-4497274
40019,Transit Authority of Northern Kentucky,Full Reporter,Urban,1730407,118006,568966,81553,5018936,518793,8036661,34581809,0,0,0,87974,0,0,34669783,42706444,2092429,318191,0,772944,725382,1816517,0,0,0,14055568,0,5988727,20044295,21860812,609846,22328215
40022,Metropolitan Atlanta Rapid Transit Authority,Full Reporter,Urban,22000562,164627946,28755801,8678407,356290554,152833697,733186967,2576808602,0,0,0,427638333,325811326,1916482,3332174743,4065361710,147688209,120687147,0,21208360,131164375,273059882,2177392233,0,310037971,151923965,0,141031254,2780385423,3053445305,38037416,1121567198
40025,Chatham Area Transit Authority,Full Reporter,Urban,2093401,2841599,390279,199123,851702,0,6376104,49490855,0,0,0,0,0,0,49490855,55866959,56711,483552,0,1400034,635922,2519508,0,0,0,808269,0,32500,840769,3360277,124735,52438658
40027,Pinellas Suncoast Transit Authority,Full Reporter,Urban,46417170,4570545,2182100,430948,0,0,53600763,88344892,0,0,0,0,0,0,88344892,141945655,11929362,3873930,0,2005812,2940818,8820560,0,0,0,35034532,5122992,2067165,42224689,51045249,3335524,99494244
40031,Lakeland Area Mass Transit District ,Full Reporter,Urban,2196973,1562981,182731,16880,5476660,0,9436225,12168297,0,0,0,0,1383392,0,13551689,22987914,4108195,922792,106850,72091,287451,1389184,0,0,1494675,7204809,0,449016,9148500,10537684,475779,16082646
40035,Central Florida Regional Transportation Authority,Full Reporter,Urban,19442592,30280931,2292266,0,0,1325643,53341432,135935312,0,0,0,3233710,7338725,4921623,151429370,204770802,5515797,13796409,8311789,2519167,6959680,31587045,1051267,0,0,4986996,5438079,0,11476342,43063387,6084622,161138590
40040,Jacksonville Transportation Authority,Full Reporter,Urban,2174784,215738564,2567822,639830,0,12961763,234082763,160018602,0,0,7304506,93056806,242943,1843229,262466086,496548849,10924821,7994599,0,6312500,1797393,16104492,0,236091590,0,186245477,320770,0,422657837,438762329,3872203,64839138
40041,Hillsborough Area Regional Transit Authority,Full Reporter,Urban,75296394,23995650,1956216,503635,0,0,101751895,112399849,0,0,0,7786591,0,0,120186440,221938335,14566634,4453957,262590,1637797,4309169,10663513,0,0,0,44905320,5908371,0,50813691,61477204,4324111,170703654
40042,Birmingham-Jefferson County Transit Authority,Full Reporter,Urban,2472706,2960336,2023188,323385,0,0,7779615,48103012,0,0,0,500309,0,9950,48613271,56392886,3621148,960377,0,508582,406195,1875154,0,0,0,29406212,0,0,29406212,31281366,1054823,27677845
40053,Greenville Transit Authority,Full Reporter,Urban,2943385,1099706,218078,84959,0,0,4346128,8536569,0,0,0,661042,0,0,9197611,13543739,0,1001983,0,0,6995,1008978,0,0,0,0,0,0,0,1008978,0,0
40057,Jackson Transit Authority,Full Reporter,Urban,307810,768547,69455,74722,0,0,1220534,5768136,0,0,0,0,0,0,5768136,6988670,545416,58789,0,189404,0,248193,1092358,0,0,0,0,0,1092358,1340551,61427,6132108
40077,South Florida Regional Transportation Authority,Full Reporter,Urban,59360789,38548514,0,1042277,0,0,98951580,619959820,0,0,0,0,0,0,619959820,718911400,4663427,11478438,0,6231193,8337522,26047153,37228033,0,0,9429098,0,11127988,57785119,83832272,1230671,638511884
40086,Metropolitan Bus Authority,Full Reporter,Urban,2005501,5256157,4093648,0,0,0,11355306,18299487,0,0,0,121599,0,0,18421086,29776392,0,83620191,323617,47189435,0,131133243,329991405,0,4857884,0,0,2089876,336939165,468072408,26250200,0
40100,Santee Wateree Regional Transportation Authority,Full Reporter,Urban,315083,253919,0,40586,0,0,609588,14114324,0,0,47823,0,0,0,14162147,14771735,446760,118705,0,0,0,118705,252737,0,0,0,0,0,252737,371442,721246,14125807
40108,Research Triangle Regional Public Transportation Authority,Full Reporter,Urban,30428121,53801020,1096404,47620,242727057,0,328100222,58849663,0,0,0,0,0,21836497,80686160,408786382,0,14389604,1038394,0,0,15427998,3720110,0,0,0,0,0,3720110,19148108,546407,0
40110,Charleston Area Regional Transportation Authority,Full Reporter,Urban,5016796,1723306,29573,244518,0,0,7014193,26878559,0,0,0,0,0,0,26878559,33892752,46962,2991788,0,19050,563869,3574707,1789072,0,0,417318,0,0,2206390,5781097,545687,27612930
40141,Central Midlands Regional Transportation Authority,Full Reporter,Urban,12919105,11277161,40399,115045,20491,0,24372201,26268841,0,0,0,0,16546216,0,42815057,67187258,226382,7872425,0,32243,32485,7937153,0,0,0,1507669,0,16242,1523911,9461064,94772,57857804
40159,Regional Transportation Authority,Full Reporter,Urban,3814864,8625829,383636,85905,0,0,12910234,29006936,0,0,0,0,0,0,29006936,41917170,0,7871735,0,26800,1243755,9142290,0,0,0,0,0,0,0,9142290,0,0
40172,Western Piedmont Regional Transit Authority ,Full Reporter,Urban,1540104,2699167,0,5036,0,1333,4245640,1653802,0,0,0,0,0,0,1653802,5899442,617970,172297,0,177613,0,349910,0,0,0,722853,0,0,722853,1072763,8332,5436317
40173,Piedmont Authority for Regional Transportation,Full Reporter,Urban,6821724,2717425,0,0,0,0,9539149,24815239,0,0,0,0,0,0,24815239,34354388,0,115825,0,54485,15153,185463,0,0,0,0,0,36019,36019,221482,97604,34035302
40191,Transit Authority of Central Kentucky,Full Reporter,Urban,230075,266789,0,0,0,32500,529364,2872944,0,0,0,0,0,0,2872944,3402308,0,82110,0,132988,170355,385453,0,0,0,0,0,3016855,3016855,3402308,0,0
40200,Tampa Bay Area Regional Transit Authority,Full Reporter,Urban,176878,1171595,0,8492,0,8168,1365133,16643,0,0,0,0,0,7318,23961,1389094,0,874502,0,87414,53943,1015859,0,0,0,0,0,450493,450493,1466352,0,0
40950,First Tennessee Human Resource Agency,Full Reporter,Urban,3151884,869826,0,98153,0,0,4119863,2278789,0,0,0,0,0,0,2278789,6398652,0,7830,0,0,0,7830,0,0,0,0,0,0,0,7830,0,0
50010,METRO Regional Transit Authority ,Full Reporter,Urban,54000849,17275314,1634841,3289293,0,0,76200297,80754526,0,0,0,601670,0,0,81356196,157556493,13775620,1891351,0,3703237,0,5594588,0,0,0,46340724,129677,0,46470401,52064989,1388910,117878214
50011,Stark Area Regional Transit Authority,Full Reporter,Urban,8387137,219104,367396,606977,2571373,4106130,16258117,36258410,51228,0,0,15294086,0,46104,51649828,67907945,6465961,3352972,0,1201480,1201544,5755996,0,0,0,26542570,0,0,26542570,32298566,284837,41790503
50012,Southwest Ohio Regional Transit Authority,Full Reporter,Urban,4486930,10653466,1422747,620317,15114777,0,32298237,98471690,0,0,0,1441559,4051636,405661,104370546,136668783,32315745,3924280,0,9456287,10620654,24001221,0,11656589,0,140384275,0,846028,152886892,176888113,2364215,-10267800
50015,The Greater Cleveland Regional Transit Authority,Full Reporter,Urban,3436397,69235231,16642987,0,51872560,2617938,143805113,641410812,0,0,55691072,79549673,36333341,5625308,818610206,962415319,98986653,19447721,10560000,30467216,3621453,64096390,127504434,0,0,391463649,0,21812068,540780151,604876541,4011322,452514109
50016,Central Ohio Transit Authority,Full Reporter,Urban,162822945,51774467,4588386,1222268,0,0,220408066,200886351,0,0,0,34800882,15978630,0,251665863,472073929,42313054,5758894,0,13535094,1949244,21243232,0,0,0,163756863,0,0,163756863,185000095,10720765,318666123
50017,Greater Dayton Regional Transit Authority,Full Reporter,Urban,6581414,18558730,4042660,1740700,9197898,0,40121402,126315916,0,0,0,30518364,16128017,272523,173234820,213356222,22815769,3042853,0,12651750,2300966,17995569,0,0,0,98521575,0,1621920,100143495,118139064,3026445,115006482
50021,Portage Area Regional Transportation Authority,Full Reporter,Urban,2666022,1778730,558916,96499,0,0,5100167,26700200,0,0,731979,0,0,0,27432179,32532346,3218381,564664,0,67859,0,632523,0,0,0,13986249,215102,0,14201351,14833874,136813,20780040
50022,Toledo Area Regional Transit Authority,Full Reporter,Urban,3995119,17862371,981981,134014,0,0,22973485,31906173,0,0,0,533093,0,14405001,46844267,69817752,4652677,4899456,0,1316951,0,6216407,0,0,0,26180963,0,13784330,39965293,46181700,4541892,23746837
50024,Western Reserve Transit Authority,Full Reporter,Urban,16578892,2567717,269771,434625,1006381,575132,21432518,23101780,0,0,0,0,0,0,23101780,44534298,4259185,227937,0,816470,246769,1291176,0,0,0,219795,0,16959100,17178895,18470071,165520,30157892
50025,Duluth Transit Authority,Full Reporter,Urban,7971523,137980,269040,69992,0,1068845,9517380,43983034,0,0,0,0,0,0,43983034,53500414,0,1138836,0,919970,118635,2177441,0,0,0,0,0,0,0,2177441,0,0
50027,Metro Transit ,Full Reporter,Urban,342428191,9031114,30229245,1374721,0,126811887,509875158,1646407702,0,0,47420649,926016973,0,676772,2620522096,3130397254,192730189,98404435,0,4264460,69693068,172361963,243861513,1436342,0,74917596,17218455,0,337433906,509795869,353419202,2459912372
50028,St. Cloud Metropolitan Transit Commission,Full Reporter,Urban,9667454,1786343,189800,97425,0,0,11741022,31443590,0,0,5149666,0,1000633,0,37593889,49334911,690581,736891,730000,432194,1406918,3306003,3236793,0,0,3539362,403222,0,7179377,10485380,850136,38689976
50029,Bay Metropolitan Transit Authority,Full Reporter,Urban,3648460,509820,389634,50887,0,0,4598801,3492264,0,0,0,27510,0,0,3519774,8118575,2198024,87084,0,894578,0,981662,0,0,0,8395353,0,0,8395353,9377015,818490,121094
50031,Suburban Mobility Authority for Regional Transportation,Full Reporter,Urban,113367102,29718396,3079493,155505,16095468,0,162415964,123251998,5000,0,0,0,0,216367,123473365,285889329,37766920,5487710,0,12414065,6718784,24620559,0,0,0,193878959,3474382,189801,197543142,222163701,25169566,76322982
50032,Mass Transportation Authority ,Full Reporter,Urban,6660841,9989065,1361891,146742,0,0,18158539,66492382,0,0,0,0,0,0,66492382,84650921,414395,6193177,86250,1217135,660517,8157079,660000,36113,0,1360361,611125,0,2667599,10824678,20115,74220523
50033,Interurban Transit Partnership,Full Reporter,Urban,18977235,1660555,577150,226625,0,12250299,33691864,111080422,290250,0,0,22510897,0,0,133881569,167573433,1124566,10504007,0,2658988,474824,13637819,0,0,0,3506015,0,0,3506015,17143834,21235242,130318923
50034,City of Jackson Transportation Authority,Full Reporter,Urban,2329700,215847,252478,30818,71512,0,2900355,1956823,0,0,0,0,0,0,1956823,4857178,711182,131382,0,109766,233835,474983,0,0,0,2515067,0,18494,2533561,3008544,89131,2470685
50035,Central County Transportation Authority,Full Reporter,Urban,6884479,3104071,466410,15000,955043,0,11425003,21622848,1080854,0,35823196,44376,0,0,58571274,69996277,7670889,711158,94770,774755,712627,2293310,3951423,0,0,11467203,49937,0,15468563,17761873,1154924,58750369
50036,Capital Area Transportation Authority,Full Reporter,Urban,54242,20485750,1475660,727396,15220426,0,37963474,53443793,0,0,0,0,0,0,53443793,91407267,5108512,2196706,0,4000869,477146,6674721,0,0,0,4064481,0,44248595,48313076,54987797,1119181,40408801
50039,Saginaw Transit Authority Regional Service,Full Reporter,Urban,722048,1483821,265568,189179,0,0,2660616,5148249,0,0,0,0,0,0,5148249,7808865,293762,128115,451646,216363,480437,1276561,0,0,0,3588,0,137232,140820,1417381,293762,6391484
50040,Ann Arbor Area Transportation Authority,Full Reporter,Urban,21762402,5438529,1000841,1136536,0,0,29338308,45730036,0,0,107155,1018582,0,0,46855773,76194081,9832,1977509,0,2601222,314586,4893317,0,0,0,919135,0,0,919135,5812452,385,70391076
50044,Fort Wayne Public Transportation Corporation,Full Reporter,Urban,2542781,1501143,408359,103175,0,0,4555458,14836089,0,0,1266187,307538,0,0,16409814,20965272,3278009,297416,0,901829,0,1199245,0,0,0,9075196,328574,6720119,16123889,17323134,3312689,3607458
50045,Gary Public Transportation Corporation,Full Reporter,Urban,449133,13963,211305,62091,0,894566,1631058,3756492,0,0,0,0,0,0,3756492,5387550,0,252493,0,123839,0,376332,0,0,0,0,0,0,0,376332,0,0
50047,Bloomington-Normal Public Transit System,Full Reporter,Urban,6695359,929600,237303,265689,0,0,8127951,19634204,0,0,0,0,0,425536,20059740,28187691,0,193747,0,335969,463064,992780,0,0,0,0,0,632196,632196,1624976,0,0
50050,Indianapolis and Marion County Public Transportation,Full Reporter,Urban,62236400,5389170,2969624,134906,0,0,70730100,169935327,0,0,0,31873617,0,12991415,214800359,285530459,0,11706820,2628117,2176134,2525283,19036354,23652830,0,0,1129939,0,1444204,26226973,45263327,1128653,239138479
50051,Greater Lafayette Public Transportation Corporation,Full Reporter,Urban,3733292,2962617,457775,144780,0,0,7298464,27245076,0,0,2525375,339146,0,0,30109597,37408061,548985,176150,740418,594340,42392,1553300,804154,0,0,3955831,0,0,4759985,6313285,688298,30955463
50052,South Bend Public Transportation Corporation,Full Reporter,Urban,271478,549602,441384,0,0,0,1262464,31342555,0,0,0,0,0,0,31342555,32605019,137947,260540,251220,0,701889,1213649,452475,0,0,875060,0,0,1327535,2541184,816127,29385655
50054,Muncie Indiana Transit System,Full Reporter,Urban,911288,12086,350885,122464,0,0,1396723,5750906,0,0,0,0,0,0,5750906,7147629,553413,42733,1374331,163060,0,1580124,0,0,15391,2199520,0,0,2214911,3795035,740407,3165600
50056,Greater Peoria Mass Transit District,Full Reporter,Urban,33195708,9054283,588298,58595,421006,0,43317890,17009235,0,0,0,0,0,0,17009235,60327125,7415903,2942320,0,1943051,0,4885371,0,0,0,7251010,14150825,0,21401835,26287206,1346034,40109788
50057,Rock Island County Metropolitan Mass Transit District,Full Reporter,Urban,2013394,4069564,35925,606327,0,0,6725210,77204532,0,0,0,0,0,1546158,78750690,85475900,876220,695624,0,563414,1559566,2818604,0,0,548548,0,149727,90989,789264,3607868,2539998,80204254
50058,Rockford Mass Transit District,Full Reporter,Urban,6587889,1526521,384248,130074,0,0,8628732,24522437,0,0,0,0,0,0,24522437,33151169,2100851,1357133,0,881679,0,2238812,0,0,0,15936748,0,2053414,17990162,20228974,0,0
50059,Springfield Mass Transit District,Full Reporter,Urban,5051375,3097662,877512,125778,0,191197,9343524,31548046,0,0,0,10670,681770,0,32240486,41584010,5761987,551790,0,823559,4140,1379489,501194,0,0,0,0,12008287,12509481,13888970,961711,32495316
50060,Champaign-Urbana Mass Transit District,Full Reporter,Urban,1656873,14784688,1542868,1338490,5655481,0,24978400,63640667,146129,0,17023891,1338930,0,0,82149617,107128017,10130666,2124066,178918,3310400,1557146,7170530,0,0,0,21100624,439342,0,21539966,28710496,2778745,85769442
50066,Chicago Transit Authority,Full Reporter,Urban,111252775,422317928,29132811,5570630,0,0,568274144,4458361024,0,0,405080447,601570543,14900091,0,5479912105,6048186249,312255099,256852696,211194806,153194253,226673300,847915055,4243086788,0,61005917,1888858158,185624897,20000,6378595760,7226510815,20093862,-886163329
50104,Northern Indiana Commuter Transportation District,Full Reporter,Urban,12365327,35456376,5918651,1852999,3335022,0,58928375,198791792,0,0,28390374,193179757,19806286,0,440168209,499096584,94407,3771371,2240000,6823917,831073,13666361,90359936,0,40096,1458522,0,0,91858554,105524915,387411,393278665
50110,Bloomington Public Transportation Corporation,Full Reporter,Urban,8800359,188936,386002,16041,0,108726,9500064,18174990,0,0,0,132355,0,0,18307345,27807409,0,133926,0,554363,0,688289,0,0,0,0,0,0,0,688289,0,0
50113,Pace - Suburban Bus Division,Full Reporter,Urban,8621878,68671487,6831042,2750957,38751069,1933072,127559505,295030654,0,0,442548,3183087,0,0,298656289,426215794,20196959,5109362,1200000,20366798,2092929,28769089,4800000,368245,0,35066967,43610888,25404061,109250161,138019250,2468837,305924666
50117,Laketran,Full Reporter,Urban,5526893,2745850,0,0,10279585,0,18552328,31906570,0,0,0,0,0,0,31906570,50458898,5724321,1564019,0,0,0,1564019,0,336817,0,21181248,0,0,21518065,23082084,4459368,28641767
50118,Northeast Illinois Regional Commuter Railroad Corporation,Full Reporter,Urban,97734808,185202427,20155040,5272924,258904107,0,567269306,3032744596,0,0,0,0,24945000,0,3057689596,3624958902,32782202,190343457,0,91229388,0,281572845,0,0,0,33086350,92140692,0,125227042,406799887,6580936,3244360281
50141,Detroit Transportation Corporation,Full Reporter,Urban,2485686,3837738,3229708,521832,21330,0,10096294,27703048,0,0,1198191,211184,2318819,0,31431242,41527536,1510561,1725355,98537,321992,424599,2570483,532477,0,0,7740979,0,0,8273456,10843939,1427283,30766875
50146,Madison County Transit District,Full Reporter,Urban,148653,3027989,802059,700665,18537914,0,23217280,53171087,0,0,0,0,30632000,0,83803087,107020367,0,2144963,0,0,0,2144963,0,0,0,0,0,0,0,2144963,0,0
50148,Blue Water Area Transportation Commission,Full Reporter,Urban,9525586,2867985,844934,335592,0,0,13574097,27048399,0,0,0,7020,0,0,27055419,40629516,1151316,638625,0,490099,233984,1362708,0,0,0,2771758,0,262221,3033979,4396687,519879,36864266
50157,Butler County Regional Transit Authority,Full Reporter,Urban,1389251,1211227,27775,171128,0,0,2799381,7352709,0,0,0,15000,0,13997,7381706,10181087,1785814,230405,0,299689,117680,647774,0,0,0,7415225,0,0,7415225,8062999,104391,3799511
50182,"Pace-Suburban Bus Division, ADA Paratransit Services",Full Reporter,Urban,27191051,668753,0,1960089,0,0,29819893,6342440,0,0,0,0,0,0,6342440,36162333,1463329,5474273,0,20128198,3373751,28976222,0,315,0,1850288,350992,0,2201595,31177817,105405,6342440
50184,Macatawa Area Express Transportation Authority,Full Reporter,Urban,2900656,346452,0,88897,0,0,3336005,7420066,0,0,0,0,0,0,7420066,10756071,0,136410,0,119678,131646,387734,0,0,0,0,0,0,0,387734,0,0
50199,Delaware County Transit Board,Full Reporter,Urban,2003691,1048610,0,32501,0,0,3084802,3980651,0,0,0,0,0,20826,4001477,7086279,866536,70864,0,134802,47370,253036,0,3731014,0,0,0,0,3731014,3984050,137109,3831656
50204,Jackson County Mass Transit District,Full Reporter,Urban,166778,122186,0,51618,0,0,340582,220156,0,0,0,0,0,0,220156,560738,0,24940,0,83427,0,108367,0,0,0,0,0,0,0,108367,0,0
50209,Central Indiana Regional Transportation Authority ,Full Reporter,Urban,317548,0,0,0,0,0,317548,0,0,0,0,0,0,0,0,317548,0,0,0,0,0,0,0,0,0,0,0,0,0,0,0,0
50211,Rides Mass Transit District,Full Reporter,Urban,4902,560120,0,712959,0,0,1277981,13939468,0,0,0,0,0,0,13939468,15217449,3386796,845279,0,0,737010,1582289,0,0,0,2118931,0,48841,2167772,3750061,0,14854184
50212,Stateline Mass Transit District,Separate Service,Urban,144478,707079,0,0,0,0,851557,131268,0,0,0,0,0,0,131268,982825,0,80702,0,0,0,80702,0,0,0,0,0,0,0,80702,0,0
50518,SouthWest Transit,Full Reporter,Urban,4024106,1292123,251508,211681,0,0,5779418,37450850,0,3289149,12076331,1753153,0,0,54569483,60348901,265945,1326558,231335,110807,170594,1839294,1107283,30105,0,1763680,0,103147,3004215,4843509,368139,55403198
50519,Minnesota Valley Transit Authority,Full Reporter,Urban,17807008,22780,55766,76348,1005830,1154,18968886,52899194,0,0,0,0,0,0,52899194,71868080,244702,4108961,19326,51876,1943492,6123655,3954941,0,75438,1315849,0,0,5346228,11469883,265885,60377014
50522,Lake Erie Transportation Commission,Full Reporter,Urban,458356,29846,237528,42283,0,1766303,2534316,333953,0,0,0,0,1562931,0,1896884,4431200,0,60765,0,105178,543571,709514,0,0,0,0,0,150000,150000,859514,0,0
60007,Fort Worth Transportation Authority,Full Reporter,Urban,263304386,44554041,1727468,1220263,10000000,0,320806158,1104530920,18424859,0,0,60088012,0,0,1183043791,1503849949,0,53906493,220294146,1166431,4837630,280204700,120000000,0,0,0,0,6292102,126292102,406496802,0,0
60008,"Metropolitan Transit Authority of Harris County, Texas ",Full Reporter,Urban,19380709,144069921,35928117,0,392187762,0,591566509,2732209582,0,0,107760712,86343060,0,5641114,2931954468,3523520977,104564462,111669469,52250000,51337689,20094658,235351816,1261391217,0,0,852841152,0,11709406,2125941775,2361293591,86226043,1180565805
60011,VIA Metropolitan Transit,Full Reporter,Urban,99055133,48102262,4816863,70833,37782319,0,189827410,337585528,0,0,2503201,64118426,20259354,0,424466509,614293919,42709303,27377552,6390000,7110082,7311754,48189388,145163965,0,0,177475681,0,0,322639646,370829034,15810107,270364081
60022,Capital Area Transit System,Full Reporter,Urban,430164,18570307,414008,97555,0,0,19512034,22127639,0,0,0,0,0,2536264,24663903,44175937,496897,3358224,0,751112,1065376,5174712,2371615,0,2193983,0,0,0,4565598,9740310,1466624,33465900
60032,New Orleans Regional Transit Authority,Full Reporter,Urban,42642401,36779999,0,2982956,0,0,82405356,281033002,0,0,0,4710417,10197195,0,295940614,378345970,11503619,412832,3151243,1220636,29672563,34457274,40173704,0,0,32096048,0,0,72269752,106727026,860709,282261854
60033,Rock Region Metropolitan Transit Authority,Full Reporter,Urban,4584465,454624,496760,103322,0,0,5639171,40706575,0,0,0,0,0,0,40706575,46345746,0,216383,0,1543746,7014,1767143,0,0,0,0,0,0,0,1767143,0,0
60048,Capital Metropolitan Transportation Authority,Full Reporter,Urban,114774903,4602886,2612103,722073,21419264,45742244,189873473,396745956,0,0,13756924,63769382,71478036,788234,546538532,736412005,15468610,28665655,0,30045508,524288,59235451,0,0,952274,56633867,0,10044975,67631116,126866567,3270114,621743934
60051,Corpus Christi Regional Transportation Authority,Full Reporter,Urban,27157466,7849913,675774,509201,0,0,36192354,71681388,0,0,0,167717,0,0,71849105,108041459,7619245,705808,815000,970515,3823518,6314841,19450000,0,0,2455449,0,2170748,24076197,30391038,3956764,81312902
60056,Dallas Area Rapid Transit,Full Reporter,Urban,98979101,138180726,37724353,5398953,447965023,6374217,734622373,3963343520,0,0,72665482,226414907,109812632,9492205,4381728746,5116351119,80678646,89099677,216706955,0,194925374,500732006,3269424609,41066331,109812632,47330153,10535478,0,3478169203,3978901209,15627478,1202501078
60059,Brazos Transit District,Full Reporter,Urban,3194400,1734162,165072,0,0,0,5093634,40236204,0,0,0,0,0,0,40236204,45329838,440606,184773,701205,363290,0,1249268,5849830,0,0,0,0,0,5849830,7099098,0,38671346
60091,Hill Country Transit District,Full Reporter,Urban,3240578,715938,319889,0,0,0,4276405,11901649,0,0,0,0,0,0,11901649,16178054,0,22637,0,50463,0,73100,0,0,0,0,0,120276,120276,193376,0,0
60101,Denton County Transportation Authority,Full Reporter,Urban,25277714,7628122,48279,269399,5010601,0,38234115,281623522,17394147,0,0,20536649,0,0,319554318,357788433,369652,1506321,1970000,782298,700088,4958707,23360000,0,0,109285,0,900000,24369285,29327992,47683,328782410
60102,Concho Valley Transit District,Full Reporter,Urban,871162,657120,0,0,0,0,1528282,8787364,0,0,76369,0,0,0,8863733,10392015,0,471275,0,0,0,471275,0,0,0,0,0,0,0,471275,48210,0
60111,Rio Metro Regional Transit District,Full Reporter,Urban,22063468,15332998,0,0,0,0,37396466,2422548,0,0,0,0,0,0,2422548,39819014,0,11451024,0,0,0,11451024,10900000,0,88451,0,0,0,10988451,22439475,0,0
70002,Transit Authority of Omaha,Full Reporter,Urban,6562261,28208662,931040,489747,0,0,36191710,58773936,0,0,91386,0,0,0,58865322,95057032,449016,5008710,0,1911110,0,6919820,0,0,0,12618312,1642824,0,14261136,21180956,5258617,69066475
70005,Kansas City Area Transportation Authority,Full Reporter,Urban,7626590,5101714,1540125,0,1351557,1244000,16863986,142416330,0,0,48374220,0,0,0,190790550,207654536,10220254,6655071,0,6065586,3514031,16234688,0,0,0,39795353,2986687,0,42782040,59016728,6627148,152230914
70006,Bi-State Development Agency of the Missouri-Illinois Metropolitan District,Full Reporter,Urban,116139706,33753252,9912198,2283018,62925936,0,225014110,859825707,0,0,0,25348703,168795813,482449,1054452672,1279466782,29438385,15742840,9630000,25461701,22318280,73152821,512480910,0,118080701,146655891,0,6408172,783625674,856778495,9261028,442865644
70010,Des Moines Area Regional Transit Authority,Full Reporter,Urban,7504484,25245209,829848,659132,0,0,34238673,55093193,0,0,0,653826,0,0,55747019,89985692,4802888,1048620,1068843,1432679,2445659,5995801,0,0,5935727,11265129,0,0,17200856,23196657,23828169,47763754
70014,Topeka Metropolitan Transit Authority,Full Reporter,Urban,4557443,1213938,37462,277449,0,0,6086292,12907732,0,0,7742762,444825,0,0,21095319,27181611,878532,143768,0,367430,420736,931934,0,0,0,3190357,0,194515,3384872,4316806,225860,23517477
80001,Utah Transit Authority,Full Reporter,Urban,122139684,93620078,36043834,2299133,124945216,0,379047945,4227148089,14392209,0,0,139699345,44906842,30736873,4456883358,4835931303,92282804,19563424,33413386,29721617,19215860,101914287,2415488275,0,0,103864839,0,0,2519353114,2621267401,2330681,2304616025
80006,Denver Regional Transportation District,Full Reporter,Urban,474332000,196444000,33354000,7458000,71775000,2037000,785400000,5853296000,0,0,0,988547000,112762000,0,6954605000,7740005000,106844000,85337000,78128000,43645000,25629000,232739000,3305181000,0,0,319177000,0,594137000,4218495000,4451234000,58737000,3336878000
80009,Missoula Urban Transportation District,Full Reporter,Urban,11918206,673446,237476,46685,0,0,12875813,5557783,0,0,0,0,0,0,5557783,18433596,0,206499,0,116731,50744,373974,0,0,0,0,0,381600,381600,755574,0,0
80012,Great Falls Transit District,Full Reporter,Urban,5055054,535469,115176,266061,0,0,5971760,4878520,0,0,17500,0,0,0,4896020,10867780,0,28679,0,253903,18104,300686,0,0,0,0,0,0,0,300686,0,0
80028,Cache Valley Transit District,Full Reporter,Urban,6904550,1191854,66000,1050,0,0,8163454,14025201,0,0,0,0,0,0,14025201,22188655,0,141426,0,167211,140000,448637,0,0,0,0,0,211000,211000,659637,0,0
90001,Regional Transportation Commission of Washoe County,Full Reporter,Urban,18075008,12666973,163742,353057,0,1381065,32639845,94683523,0,0,0,0,0,0,94683523,127323368,0,5752522,0,0,1854726,7607248,0,4092764,0,4941709,0,0,9034473,16641721,0,0
90003,San Francisco Bay Area Rapid Transit District,Full Reporter,Urban,275234913,137408354,51118223,13549497,409015513,2767807,889094307,6997413894,0,0,408946021,1417609184,0,12778877,8836747976,9725842283,209599503,180468390,53840000,92171950,22600603,349080943,1411252075,71137263,0,1097766821,61776120,84150667,2726082946,3075163889,90125659,6770152238
90004,Golden Empire Transit District,Full Reporter,Urban,12754923,6599802,1083473,85055,0,0,20523253,36840949,0,0,0,0,0,0,36840949,57364202,0,651968,0,2147826,0,2799794,0,0,0,0,5470797,6587655,12058452,14858246,0,0
90006,Santa Cruz Metropolitan Transit District,Full Reporter,Urban,16780231,5148845,783335,699251,0,9465255,32876917,80988420,0,0,11294220,2484139,0,0,94766779,127643696,13543340,1684722,0,4261061,437184,6382967,0,11694242,1170438,172384500,2031008,162705,187442893,193825860,5818771,-58457595
90009,San Mateo County Transit District,Full Reporter,Urban,103812805,62092360,1770252,2077674,31191950,31587,200976628,151438968,0,0,0,5186551,99865686,0,256491205,457467833,23991233,20283166,10060000,18433226,31224387,80000779,206374874,0,0,101369802,16659457,0,324404133,404404912,2996945,74057209
90012,San Joaquin Regional Transit District,Full Reporter,Urban,4509278,22102809,823217,589552,0,4761,28029617,128574325,0,0,139311,395321,0,0,129108957,157138574,6119624,4883596,0,2550583,2352770,9786949,11800000,0,0,0,39468000,3682602,54950602,64737551,2121337,96399310
90013,Santa Clara Valley Transportation Authority,Full Reporter,Urban,7734000,86821000,33318000,3090000,662218000,0,793181000,1840559000,2203000,0,0,3353507000,0,72441000,5268710000,6061891000,88699000,35145000,14788000,6562000,17744000,74239000,145681000,0,0,313292000,0,0,458973000,533212000,28863000,5588515000
90014,Alameda-Contra Costa Transit District,Full Reporter,Urban,92997824,74326561,12485906,10223272,40017969,0,230051532,340461858,0,0,0,105077799,0,0,445539657,675591189,103529471,18782883,17098155,53648685,1315824,90845547,11000000,0,0,493447988,62675064,0,567123052,657968599,51153431,69998630
90016,"Golden Gate Bridge, Highway and Transportation District",Full Reporter,Urban,2356,52633644,4915767,609070,0,0,58160837,114214282,0,0,0,100644550,0,0,214858832,273019669,19981925,22547387,0,5999706,2349687,30896780,389542,0,0,123836000,9621783,0,133847325,164744105,2967750,125289739
90019,Sacramento Regional Transit District,Full Reporter,Urban,18308892,70856390,23753153,12338,324055,0,113254828,845102536,0,0,62844833,34278739,2981153,0,945207261,1058462089,50074044,18158302,19976106,13434587,4314966,55883961,49628200,1250000,45028404,135914061,15581002,16526597,263928264,319812225,12679842,776044066
90020,Santa Barbara Metropolitan Transit District,Full Reporter,Urban,10583678,7483281,867288,201518,0,0,19135765,32641201,0,0,1123847,2707497,0,0,36472545,55608310,0,512191,0,1031305,973416,2516912,0,761234,0,1120672,3388885,1387889,6658680,9175592,0,0
90023,Long Beach Transit,Full Reporter,Urban,49898830,4059527,2226666,1576840,0,0,57761863,89575424,0,0,0,1493480,27052581,0,118121485,175883348,15468079,2590694,0,785224,56736361,60112279,0,0,0,33013550,4248319,16849059,54110928,114223207,0,0
90026,San Diego Metropolitan Transit System,Full Reporter,Urban,40458636,2449357,20747837,2435100,0,0,66090930,1720943551,0,0,0,0,0,0,1720943551,1787034481,34251711,18031068,2555000,9031179,141755,29759002,10355000,0,0,206466877,14617396,0,231439273,261198275,7371772,1552716145
90029,Omnitrans,Full Reporter,Urban,1703910,24171703,2699470,438821,0,0,29013904,179609275,0,0,0,20661288,52869590,0,253140153,282154057,10123681,6263857,0,3213614,6127489,15604960,0,7117925,0,25090326,0,36236352,68444603,84049563,0,208228175
90030,North County Transit District,Full Reporter,Urban,76290651,16144170,4488305,1620919,0,0,98544045,472100640,0,0,5897924,50150645,0,0,528149209,626693254,7187112,19337776,1250000,1572827,17496782,39657385,23050000,0,0,43758770,1083889,16425799,84318458,123975843,142473,509762050
90031,Riverside Transit Agency,Full Reporter,Urban,59013296,19420904,815614,286717,0,0,79536531,88710494,0,0,0,0,0,8539035,97249529,176786060,30467394,7232964,0,6394430,58707067,72334461,0,0,0,23039238,0,0,23039238,95373699,782568,111097187
90035,Gold Coast Transit District,Full Reporter,Urban,3777365,2604119,613659,89529,0,0,7084672,17635002,0,0,9859907,43876567,0,0,71371476,78456148,4719702,2477947,1375785,0,2938970,6792702,23278115,0,0,12461752,0,0,35739867,42532569,1651368,38991913
90036,Orange County Transportation Authority,Full Reporter,Urban,406220968,138121286,2302303,12679177,0,0,559323734,274975412,0,0,0,13949686,0,0,288925098,848248832,54245697,29269149,6888404,4446044,15381831,55985428,0,0,0,192900605,0,1013268,193913873,249899301,24221837,628373391
90045,Regional Transportation Commission of Southern Nevada,Full Reporter,Urban,25154135,139816027,0,572864,455795185,0,621338211,443868000,0,0,0,0,0,0,443868000,1065206211,26224292,58958127,53115526,18475093,276021,130824767,747576561,0,0,49753570,14017817,0,811347948,942172715,13995098,135262690
90061,Yuba-Sutter Transit Authority,Full Reporter,Urban,2778524,2029033,0,45876,0,0,4853433,11898045,0,0,0,803111,0,0,12701156,17554589,127450,1409352,0,37539,786734,2233625,0,0,0,338485,0,25075,363560,2597185,15547,15069307
90062,Monterey-Salinas Transit,Full Reporter,Urban,15308567,9215717,301679,377196,0,0,25203159,63494589,0,0,0,3348871,0,8825,66852285,92055444,4251494,5194855,774462,2243427,3310719,11523463,3714904,0,0,14556244,1413707,0,19684855,31208318,1192137,63906483
90078,Central Contra Costa Transit Authority,Full Reporter,Urban,13364137,4215268,907214,148459,0,0,18635078,54267330,0,0,0,74747,0,0,54342077,72977155,5290416,2359438,38000,3303571,10434462,16135471,0,0,0,8493326,0,5266663,13759989,29895460,3346110,45026001
90079,SunLine Transit Agency,Full Reporter,Urban,8633093,5211359,936282,491753,0,1521272,16793759,51778590,0,0,0,21643002,0,0,73421592,90215351,4402261,1091116,0,255429,11471582,12818127,2048074,0,0,4033495,0,0,6081569,18899696,1699886,74018030
90088,Napa Valley Transportation Authority,Full Reporter,Urban,995307,3502577,408951,55938,419748,0,5382521,22508328,0,0,0,0,0,0,22508328,27890849,0,2567422,0,938857,469636,3975915,0,0,0,0,0,0,0,3975915,0,0
90090,Yolo County Transportation District,Full Reporter,Urban,6267166,4201032,0,0,0,0,10468198,18186462,0,0,1519678,0,0,0,19706140,30174338,579043,1564041,0,555229,0,2119270,0,0,0,1317300,0,0,1317300,3436570,67473,27249338
90093,Redding Area Bus Authority,Full Reporter,Urban,4272495,35014,91988,0,1550177,0,5949674,11826953,0,0,0,0,0,0,11826953,17776627,0,0,0,0,4529299,4529299,0,0,0,0,0,0,0,4529299,0,0
90121,Antelope Valley Transit Authority,Full Reporter,Urban,12473236,7885220,404670,557748,11384028,0,32704902,74420034,0,0,0,0,0,0,74420034,107124936,677049,13281303,0,503260,0,13784563,0,0,0,1071984,0,1131487,2203471,15988034,54474,91759477
90134,Peninsula Corridor Joint Powers Board,Full Reporter,Urban,63275432,124415239,7360578,8049,12707925,0,207767223,943359036,0,0,0,1124617573,0,0,2067976609,2275743832,0,67882939,25000000,887433,63273805,157044177,55416971,0,0,0,0,0,55416971,212461148,0,0
90136,Regional Public Transportation Authority,Full Reporter,Urban,28963937,62195121,0,212208,48746968,9780000,149898234,84040572,0,0,25043715,3368612,13331663,74362,125858924,275757158,7938794,37924290,21654300,2226999,754885,62560474,136788885,0,0,28445824,0,783642,166018351,228578825,4117236,50999891
90144,Livermore / Amador Valley Transit Authority,Full Reporter,Urban,10796511,3227547,0,259412,0,3272092,17555562,31559920,0,0,0,28149267,0,0,59709187,77264749,776033,1658966,0,70036,835633,2564635,0,13093436,0,1051448,678489,1819381,16642754,19207389,119266,58714127
90146,Foothill Transit,Full Reporter,Urban,47811665,13342571,0,4756603,0,0,65910839,224058977,0,0,0,0,45477908,716195,270253080,336163919,0,12138484,0,0,0,12138484,62274137,0,0,0,0,0,62274137,74412621,0,0
90148,Victor Valley Transit Authority,Full Reporter,Urban,23280617,6723935,0,67185,0,0,30071737,69230641,0,0,0,0,0,0,69230641,99302378,1440365,1444179,800000,2518047,8875066,13637292,32997893,0,0,0,162489,0,33160382,46797674,20720,53924349
90151,Southern California Regional Rail Authority,Full Reporter,Urban,86783034,83825983,15556726,838239,0,0,187003982,1344092445,0,632883,0,0,46817509,0,1391542837,1578546819,7343249,48118461,0,22554029,105039052,175711542,0,12136629,571114,11297847,0,18996000,43001590,218713132,1340458,1365836478
90154,Los Angeles County Metropolitan Transportation Authority ,Full Reporter,Urban,78655441,601057413,60663961,6985896,130808118,67960852,946131681,14947111885,0,0,1316241608,0,240777169,12392671,16516523333,17462655014,209720273,331434024,304328310,262379684,182543431,1080685449,6225757314,0,0,1779307722,308998243,46161267,8360224546,9440909995,356868142,7874597150
90157,Access Services  ,Full Reporter,Urban,2807280,11528138,0,0,25140668,5096062,44572148,9956239,0,0,0,0,0,39129,9995368,54567516,0,16628629,0,1285637,26818381,44732647,0,0,0,0,0,0,0,44732647,0,0
90159,Western Contra Costa Transit Authority,Full Reporter,Urban,3783667,1444049,0,52998,0,0,5280714,15500649,0,0,0,0,0,0,15500649,20781363,186496,1556354,0,31971,3216727,4805052,0,0,0,521412,0,475662,997074,5802126,24540,15141193
90162,The Eastern Contra Costa Transit Authority,Full Reporter,Urban,3047748,2387192,786531,0,602711,0,6824182,32363397,0,0,0,0,0,370599,32733996,39558178,0,3711817,23911,356859,100705,4193292,1352880,0,0,0,355782,0,1708662,5901954,0,0
90164,Ventura County Transportation Commission,Full Reporter,Urban,1203445,472120,0,1100,0,0,1676665,9412537,0,0,0,0,0,0,9412537,11089202,58365,1174151,0,8719,502515,1685385,0,0,0,135011,0,23105,158116,1843501,10300,9293766
90173,Transit Joint Powers Authority for Merced County,Full Reporter,Urban,6582553,9302,0,0,0,25260886,31852741,19605994,0,0,0,0,0,0,19605994,51458735,0,1024862,0,0,4002316,5027178,0,0,0,0,0,0,0,5027178,0,0
90182,Altamont Corridor Express,Full Reporter,Urban,42700950,10547259,1609065,2953783,0,8435,57819492,178449191,0,0,2741915,0,0,0,181191106,239010598,0,4592433,2554530,2086888,20751272,29985123,44489007,0,0,0,32103,167445,44688555,74673678,0,0
90200,Kings County Area Public Transit Agency,Full Reporter,Urban,6737263,147207,0,212,0,0,6884682,11359122,0,0,210409,169639,0,0,11739170,18623852,103380,464295,285862,0,3617708,4367865,0,0,6337,0,0,0,6337,4374202,11958,14341072
90206,San Luis Obispo Regional Transit Authority,Full Reporter,Urban,5575015,3632558,207087,143164,0,2000,9559824,16045375,0,0,0,0,0,0,16045375,25605199,309803,1171961,0,439428,5741257,7352646,0,0,0,598258,129047,2939466,3666771,11019417,30287,14865298
90209,"Valley Metro Rail, Inc.",Full Reporter,Urban,4999744,76839181,17523030,0,0,801288,100163243,1221917391,0,0,9879739,322988984,0,0,1554786114,1654949357,0,40698200,9780000,14082473,44113981,108674654,25043715,0,0,0,921644,9168999,35134358,143809012,0,0
90211,Anaheim Transportation Network,Full Reporter,Urban,768693,2598221,191415,80144,0,1841365,5479838,7338654,0,0,0,0,0,0,7338654,12818492,0,4275401,230061,317131,84318,4906911,3202842,0,0,0,0,0,3202842,8109753,0,0
90219,Northern Arizona Intergovernmental Public Transportation Authority,Full Reporter,Urban,771530,2219634,282246,78291,0,0,3351701,30401853,0,0,0,946883,0,0,31348736,34700437,1412727,457986,0,603973,6489,1068448,0,0,0,6456563,0,1158064,7614627,8683075,417750,27012339
90223,"Paratransit, Inc.",Full Reporter,Urban,3396150,1263184,88924,653788,0,0,5402046,10367050,0,0,0,0,0,0,10367050,15769096,0,972748,38254,289263,31583,1331848,4202857,0,0,0,0,0,4202857,5534705,0,0
90225,San Francisco Bay Area Water Emergency Transportation Authority,Full Reporter,Urban,57533362,8378198,93215,3680464,0,0,69685239,298117094,0,0,0,120515565,0,0,418632659,488317898,703551,6053926,0,6525286,9000,12588212,0,36818511,0,0,0,0,36818511,49406723,148511,439466215
90226,Imperial County Transportation Commission,Full Reporter,Urban,11167024,53853,0,0,0,0,11220877,6771705,0,0,0,0,0,0,6771705,17992582,0,0,0,0,643757,643757,0,0,0,0,0,0,0,643757,0,0
90229,El Dorado County Transit Authority,Full Reporter,Urban,5549579,1962289,246482,6159,0,0,7764509,12293411,0,0,0,1349266,0,0,13642677,21407186,1105764,479757,366826,79864,3338201,4264648,996220,0,0,2950847,0,197167,4144234,8408882,316322,13787746
90232,Solano County Transit,Full Reporter,Urban,4256652,1945432,0,96267,3090917,0,9389268,51044390,0,0,0,0,0,0,51044390,60433658,165150,1135230,0,112469,8257747,9505446,0,0,0,0,0,0,0,9505446,0,0
90233,Yuma County Intergovernmental Public Transportation Authority,Full Reporter,Urban,230667,1696462,0,0,0,1388,1928517,7158396,0,0,0,0,0,0,7158396,9086913,125198,1289463,0,0,1539560,2829023,0,0,0,393484,0,0,393484,3222507,54243,5935361
90234,Marin County Transit District,Full Reporter,Urban,22486562,9716309,3039,11152,0,0,32217062,27303887,0,0,0,1454572,0,0,28758459,60975521,0,4223024,0,0,730796,4953820,0,0,0,0,0,29091,29091,4982911,0,0
90299,Sonoma-Marin Area Rail Transit District,Full Reporter,Urban,45845926,21981361,2962805,1387771,23603697,1673951,97455511,477680890,325040,0,0,65324720,0,0,543330650,640786161,2126418,8485085,11872533,607071,2940718,23905407,147769549,0,0,2866189,0,546713,151182451,175087858,260112,467564609
91092,Tahoe Transportation District,Full Reporter,Urban,1409617,964795,182896,22092,0,0,2579400,1513386,0,0,0,1173336,0,0,2686722,5266122,0,234934,0,24950,0,259884,124852,0,0,0,0,0,124852,384736,0,0
99425,Pomona Valley Transportation Authority,Full Reporter,Urban,3509153,0,0,0,0,245966,3755119,219235,0,0,0,0,0,0,219235,3974354,0,0,0,0,0,0,0,0,0,0,1848264,0,1848264,1848264,0,0
