NTD ID,Agency Name,Reporter Type,Reporting Module,CA: Cash and Cash Equivalents,CA: Accounts Receivable,CA: Inventory,CA: Prepaid Expenses,CA: Current Investments and Current Portions of Long-Term Investments,CA: Other Current Assets,Total Current Assets,NCA: Capital Assets,NCA: Intangible Assets,NCA: Capital Leases Receivables,NCA: Special Funds,NCA: Work in Progress,NCA: Investments,NCA: Other Noncurrent Assets,Total Noncurrent Assets,Total Assets,Deferred Outflows of Resources,CL: Current Accounts Payable,CL: Short-Term Debt and Current Portions of Long-Term Debt,CL: Accrued Liabilities,CL: Other Current Liabilities,Total Current Liabilities,NCL: Long-Term Debt,NCL: Noncurrent Accounts Payable,NCL: Capital Lease Obligations,NCL: Long-Term Pension Liabilities,NCL: Estimated Liabilities,NCL: Other Noncurrent Liabilities,Total Noncurrent Liabilities,Total Liabilities,Deferred Inflows of Resources,Net Position
2,Spokane Transit Authority,Full Reporter: Operating,Urban,243221697,35180559,2080329,848305,0,0,281330890,201664419,7275425,0,0,11737892,0,14714354,235392090,516722980,16611545,9046292,0,9116192,1630646,19793130,0,0,841297,11540708,0,0,12382005,32175135,13447205,487712185
3,Pierce County Transportation Benefit Area Authority,Full Reporter: Operating,Urban,1776139,110116,5338141,1295973,10611928,33322008,52454305,147619300,0,0,91078764,66778458,130501523,20129411,456107456,508561761,18304037,4518030,0,0,4800695,9318725,0,0,4706506,9460689,8816420,0,22983615,32302340,12279496,482283962
7,Lane Transit District,Full Reporter: Operating,Urban,80488996,29843306,1787845,804991,0,0,112925138,152519454,0,0,0,0,0,0,152519454,265444592,9769236,2670636,0,4196318,19376903,26243857,0,0,0,31623961,0,0,31623961,57867818,4119807,213226203
8,Tri-County Metropolitan Transportation District of Oregon,Full Reporter: Operating,Urban,221682019,66273268,67105750,8746194,449191723,127924649,940923603,2432560754,0,53634433,36366698,720660701,165227170,3980557,3412430313,4353353916,192944688,60929997,31545000,52082452,80245632,224803081,1008081301,2503220,0,844898457,27454041,37304598,1920241617,2145044698,406604117,1994649789
11,Valley Regional Transit,Full Reporter: Operating,Urban,1348543,3430001,575238,310070,0,0,5663852,35998097,0,0,0,5450154,0,0,41448251,47112103,918875,1683056,0,684235,328499,2695790,5320648,0,411007,2302087,0,0,8033742,10729532,0,37301446
18,Ben Franklin Transit,Full Reporter: Operating,Urban,66292231,39899764,740976,526620,0,0,107459591,43573372,1097109,0,0,18304378,0,7986298,70961157,178420748,6026672,3472224,0,1543815,0,5016039,0,0,0,2968465,0,2355602,5324067,10340106,3766835,170340479
19,Intercity Transit,Full Reporter: Operating,Urban,217129709,34148551,1337514,1212528,0,0,253828302,117454600,4299189,0,0,10557109,0,9200806,141511704,395340006,10229576,2248005,0,2248705,995368,5492078,0,0,909265,13879676,0,3278922,18067863,23559941,9393509,372616132
20,Kitsap County Public Transportation Benefit Area Authority,Full Reporter: Operating,Urban,1262800,29402316,6759612,737543,125799847,0,163962118,136362436,268896,0,148221,58436439,0,7451572,202667564,366629682,8032115,3428201,3398884,3620806,0,10447891,26437156,0,0,4402697,0,0,30839853,41287744,10767814,322606239
21,Whatcom Transportation Authority,Full Reporter: Operating,Urban,57508477,10947689,1513917,336118,0,0,70306201,44721172,2496174,545739,0,1382627,0,7204214,56349926,126656127,5703277,828150,0,3768929,8333,4605412,0,0,1591080,3135036,0,1283330,6009446,10614858,4792306,116952240
24,Clark County Public Transportation Benefit Area Authority,Full Reporter: Operating,Urban,0,31192891,3840621,1856667,0,0,36890179,161754434,7478504,0,183352525,38890497,0,9822371,401298331,438188510,8707777,6092436,0,6047456,352741,12492633,0,0,0,4262409,707607,614994,5585010,18077643,5653335,423165309
25,Salem Area Mass Transit District,Full Reporter: Operating,Urban,11358805,14454314,826872,1197725,0,1829,27839545,43163706,0,0,0,9722334,49628896,0,102514936,130354481,7036187,1986269,0,4010604,6107208,12104081,0,0,0,7428998,0,0,7428998,19533079,3658225,114199364
29,Snohomish County Public Transportation Benefit Area Corporation,Full Reporter: Operating,Urban,264369808,95004023,2317170,922928,0,0,362613929,252483640,9736860,0,1638088,73041041,192739113,21158426,550797168,913411097,21491710,11596922,1322361,10944892,3743915,27608090,4092395,0,0,21313459,2453174,0,27859028,55467118,17275900,862159789
34,Rogue Valley Transportation District,Full Reporter: Operating/Building,Urban,16153881,9179529,659426,330073,0,0,26322909,26712109,0,0,0,0,0,0,26712109,53035018,0,251335,61870,4826239,0,5139444,91109,0,0,0,0,0,91109,5230553,0,47804465
40,Central Puget Sound Regional Transit Authority,Full Reporter: Operating,Urban,763872176,572268456,45655893,16703425,1536334989,932543,2935767482,9460006519,867044612,343918632,326618841,8844480540,2344443402,21517380,22208029926,25143797408,4983148,307354357,77870000,75347047,187352801,647924205,3631647991,0,157035826,0,0,13485280,3802169097,4450093302,23251745,20675435509
43,Chelan Douglas PTBA ,Full Reporter: Operating,Urban,2470801,5894932,629627,131669,31777220,0,40904249,43779744,0,0,3415167,2735,0,0,47197646,88101895,2923161,1031202,0,1259169,0,2290371,0,0,0,1445609,0,73681,1519290,3809661,2085308,85130087
44,Skagit Transit,Full Reporter: Operating,Urban,26426607,6726331,783061,194736,0,0,34130735,25434209,259717,0,0,8023505,0,448527,34165958,68296693,0,361009,0,1416581,0,1777590,0,0,28149,0,0,482257,510406,2287996,0,66008697
10001,Rhode Island Public Transit Authority,Full Reporter: Operating,Urban,8612425,13364673,1844743,165133,2170764,0,26157738,119939375,0,0,5478219,43264358,5930688,2889052,177501692,203659430,50476307,6997945,810269,8691816,2215414,18715444,6381230,0,0,153771732,10955255,717256,171825473,190540917,33600587,29994233
10003,Massachusetts Bay Transportation Authority,Full Reporter: Operating,Urban,654290098,254581078,71112138,21652991,357545350,409536346,1768718001,15739534289,0,144621158,0,0,0,700189551,16584344998,18353062999,804100727,416907319,406492162,236737751,0,1060137232,5593457687,0,99350211,3561552001,0,174223315,9428583214,10488720446,1065296346,7603146934
10004,Brockton Area Transit Authority,Full Reporter: Operating,Urban,2151709,8504311,0,0,0,87732,10743752,20123665,0,0,0,0,0,1594797,21718462,32462214,1565815,117406,0,3888166,1298285,5303857,6100000,0,0,1527842,0,1242384,8870226,14174083,687190,19166756
10005,Lowell Regional Transit Authority,Full Reporter: Operating,Urban,1807693,6027329,0,127769,0,267130,8229921,33299856,0,0,0,0,0,504966,33804822,42034743,0,1478509,6200000,208147,11733,7898389,0,0,0,1183327,0,331532,1514859,9413248,121864,32499631
10006,Southeastern Regional Transit Authority,Full Reporter: Operating,Urban,2035041,14655768,1110587,170725,0,0,17972121,25171255,0,469518,0,258643,0,0,25899416,43871537,8389757,6960944,6009460,436893,0,13407297,0,0,469518,11226288,937449,0,12633255,26040552,4845899,21374843
10007,Berkshire Regional Transit Authority,Full Reporter: Operating,Urban,827640,5289729,0,17070,0,713741,6848180,10993686,0,66640,0,0,0,0,11060326,17908506,393430,2563,5350000,226161,227175,5805899,0,0,0,720714,0,0,720714,6526613,239552,11535771
10008,Pioneer Valley Transit Authority,Full Reporter: Operating,Urban,1707382,20475090,0,208483,3594265,0,25985220,102204886,0,0,3927987,0,0,5276775,111409648,137394868,7880614,7957631,14500000,116778,3179923,25754332,0,0,0,44664426,0,5439297,50103723,75858055,8233692,61183735
10013,Merrimack Valley Regional Transit Authority,Full Reporter: Operating,Urban,1157434,12811099,0,172143,0,0,14140676,56235333,0,0,1086551,0,0,0,57321884,71462560,399114,3248423,10961144,72748,0,14282315,0,0,0,972984,0,944912,1917896,16200211,0,55661463
10014,Worcester Regional Transit Authority,Full Reporter: Operating,Urban,2308414,12119523,462563,137130,0,0,15027630,100370942,510592,0,0,0,0,0,100881534,115909164,4480858,1913592,11800000,358333,103308,14175233,0,0,0,16257143,7986476,0,24243619,38418852,727176,81243994
10016,Greater Portland Transit District,Full Reporter: Operating,Urban,3029361,1494206,409188,109868,0,0,5042623,17005178,0,0,0,62700,0,0,17067878,22110501,11242,332940,199150,428020,0,960110,2539411,0,0,800698,5000,457374,3802483,4762593,679697,16679453
10017,Greater Hartford Transit District,Full Reporter: Operating,Urban,2760105,9643820,0,194178,1144168,0,13742271,35133006,0,0,0,0,4576674,0,39709680,53451951,0,7841735,0,0,480430,8322165,0,0,0,787449,0,0,787449,9109614,5695563,38646774
10040,Southeast Area Transit District,Full Reporter: Operating,Urban,60857,1448712,226777,343481,0,0,2079827,8761796,0,0,0,0,0,0,8761796,10841623,0,229966,579372,336888,0,1146226,0,0,0,0,0,0,0,1146226,0,9695397
10042,Valley Transit District,Full Reporter: Operating,Urban,313031,313316,0,9281,0,0,635628,4156479,0,0,0,0,0,0,4156479,4792107,0,23799,0,108745,0,132544,0,0,0,0,0,0,0,132544,0,4659563
10049,Greater New Haven Transit District,Full Reporter: Operating,Urban,327622,2372857,75135,42654,0,0,2818268,6195169,0,0,0,0,0,0,6195169,9013437,0,143761,500000,759758,150909,1554428,74203,0,0,0,0,0,74203,1628631,0,7384806
10050,Greater Bridgeport Transit Authority,Full Reporter: Operating,Urban,1646483,5264717,1389213,1702,0,0,8302115,29966986,0,0,0,1383987,0,0,31350973,39653088,527996,1174857,391227,3268234,34421,4868739,0,0,0,9707412,402699,0,10110111,14978850,3684407,21517827
10051,Housatonic Area Regional Transit ,Full Reporter: Operating,Urban,123762,1700924,115119,66560,450845,0,2457210,33625189,0,0,0,0,3074760,0,36699949,39157159,0,363671,22389,209467,0,595527,48479,0,0,0,0,0,48479,644006,0,38513153
10053,Cape Ann Transportation Authority,Full Reporter: Operating,Urban,46592,4606743,75292,230579,1120137,0,6079343,6580631,0,277641,0,0,0,0,6858272,12937615,0,1576074,0,122317,0,1698391,2413000,0,0,0,0,0,2413000,4111391,351042,8475182
10057,Norwalk Transit District,Full Reporter: Operating,Urban,0,1828230,528620,182568,0,0,2539418,27033067,0,0,0,4453349,0,0,31486416,34025834,0,1008051,2456464,961070,0,4425585,0,0,0,0,288649,0,288649,4714234,0,29311600
10061,Montachusett Regional Transit Authority,Full Reporter: Operating,Urban,19797707,30017489,0,0,0,1041465,50856661,52610244,0,0,0,0,0,0,52610244,103466905,0,42539953,19053333,519556,817566,62930408,103338,0,0,0,0,0,103338,63033746,0,40433159
10064,Greater Attleboro-Taunton Regional Transit Authority,Full Reporter: Operating,Urban,7711164,17316809,379849,1148589,0,0,26556411,23841597,0,0,0,0,0,4797167,28638764,55195175,1912743,13855216,8200880,621557,308550,22986203,0,0,0,7852557,0,236969,8089526,31075729,1332807,24699382
10066,Green Mountain Transit Authority,Full Reporter: Operating,Urban,4855630,4266811,955141,233334,0,0,10310916,63959892,0,0,0,47315,0,0,64007207,74318123,806103,625086,0,1474846,12720,2112652,0,0,0,0,0,0,0,2112652,0,73011574
10086,Cooperative Alliance for Seacoast Transportation,Full Reporter: Operating,Urban,2287036,1186628,103058,50019,0,0,3626741,3966282,0,0,0,0,0,0,3966282,7593023,0,146452,0,315415,95034,556901,0,0,0,0,0,0,0,556901,0,7036122
10088,Casco Bay Island Transit District,Full Reporter: Operating,Urban,2240296,495318,62836,98356,0,0,2896806,8565398,0,0,804837,19788280,0,0,29158515,32055321,0,446853,0,263573,2687,713113,0,0,0,0,0,1110093,1110093,1823206,0,30232115
10098,"Western Maine Transportation Services, Inc.",Full Reporter: Operating,Urban,1382978,1236902,152563,134905,0,0,2907348,1845049,0,0,0,4236981,0,0,6082030,8989378,0,122988,0,159710,0,282698,1192895,0,0,0,0,266288,1459183,1741881,0,7247497
10105,Cape Cod Regional Transit Authority,Full Reporter: Operating,Urban,2892223,5136393,0,0,0,1261050,9289666,26950940,205184,0,0,0,0,3180739,30336863,39626529,811417,3327823,0,205965,0,3533788,0,444112,0,2065048,0,2108935,4618095,8151883,987584,31298479
10107,Milford Transit District,Full Reporter: Operating,Urban,501203,203413,0,0,0,0,704616,4116872,0,0,0,0,0,0,4116872,4821488,0,119091,0,76002,0,195093,3911151,0,0,0,0,55000,3966151,4161244,150306,509938
10115,Northern New England Passenger Rail Authority,Full Reporter: Operating,Urban,1321174,5316050,0,132306,0,0,6769530,13169681,0,1290298,0,711273,0,948405,16119657,22889187,540120,2645076,0,80170,0,2725246,0,0,0,1079252,0,1908028,2987280,5712526,464229,17252552
10118,MetroWest Regional Transit Authority,Full Reporter: Operating,Urban,1510226,4721786,0,150683,0,0,6382695,23549929,0,0,5252673,0,0,0,28802602,35185297,0,1530836,0,402373,0,1933209,0,774159,0,1051105,0,8928000,10753264,12686473,782305,21716519
10128,Connecticut Department of Transportation- CTTransit Waterbury- NET,Full Reporter: Operating,Urban,496118,584397,1416258,206324,0,0,2703097,0,0,0,0,0,0,5021494,5021494,7724591,0,69668,94482,1833648,0,1997798,0,0,0,0,0,1132100,1132100,3129898,0,4594693
10183,"Woods Hole, Martha's Vineyard and Nantucket Steamship Authority",Full Reporter: Operating,Urban,12681205,2772635,645717,5039369,8659571,0,29798497,203947339,0,0,55269585,37286271,0,3226734,299729929,329528426,6079246,6830403,9656827,5469955,10770739,32727924,90827605,0,0,22662051,0,446864,113936520,146664444,4805323,184137905
20002,Capital District Transportation Authority,Full Reporter: Operating,Urban,23115280,38142223,0,0,0,5291574,66549077,156907960,0,5698006,47112400,0,0,2045372,211763738,278312815,16426142,11020387,0,0,5008760,16029147,0,0,11685098,66724317,10353900,0,88763315,104792462,58365914,131580581
20004,Niagara Frontier Transportation Authority,Full Reporter: Operating,Urban,98657000,57531000,5616000,1158000,64138000,0,227100000,310698000,3017000,28000,20117000,0,8000000,0,341860000,568960000,76422000,18858000,2936000,0,28142000,49936000,2776000,0,0,418717000,30326000,0,451819000,501755000,146826000,-3199000
20008,MTA New York City Transit,Full Reporter: Operating,Urban,1107695938,3768426908,350176531,258821304,5690661267,0,11175781948,44275001771,0,39362713,1106640476,7814729446,1124847862,98726122,54459308390,65635090338,6134462046,5375127523,706878236,2163435978,1197544856,9442986593,16654561622,8238494165,714461470,21605672411,4218004814,281742299,51712936781,61155923374,3893334072,6720294938
20018,Central New York Regional Transportation Authority,Full Reporter: Operating,Urban,25440341,18318145,3658710,5072280,0,0,52489476,84672955,0,0,0,388454,0,40484110,125545519,178034995,40480338,1728657,0,3151654,1723835,6604146,0,0,0,256315853,3501620,43420921,303238394,309842540,133526786,-224853993
20075,Port Authority Transit Corporation,Full Reporter: Operating,Urban,2069476,4443523,7628268,1669583,2989635,0,18800485,0,1545218,0,142500,0,0,0,1687718,20488203,17048188,4412489,0,1746893,13862911,20022293,0,1353290,0,24749994,2974665,305950000,335027949,355050242,525393,-318039244
20078,"Metro-North Commuter Railroad Company, dba: MTA Metro-North Railroad",Full Reporter: Operating,Urban,170409122,567769440,172590258,176664508,880124570,4939293,1972497191,4915396234,0,0,0,2634614224,154938159,81407189,7786355806,9758852997,1091882399,104927936,96539813,1238144215,158711909,1598323873,2288317851,43864123,255174040,2672448292,101874323,1141986095,6503664724,8101988597,583934089,2164812710
20080,New Jersey Transit Corporation,Full Reporter: Operating,Urban,230044930,65634836,162830661,0,0,717063540,1175573967,4297630613,0,0,1085199553,3105728523,0,18795713,8507354402,9682928369,636698249,332889315,330911241,165025045,219916201,1048741802,1451194188,0,0,954789010,1847610223,674266834,4927860255,5976602057,313989386,4029035175
20098,Port Authority Trans-Hudson Corporation,Full Reporter: Operating,Urban,276253345,1504207844,54491524,81130213,1348882987,169960776,3434926689,39810228383,0,8091095686,0,633976617,3756222715,6427824498,58719347899,62154274588,1543797842,929749449,565986022,1007056381,7620146,2510411998,27573526260,1232505000,6424743397,3534544883,0,329699753,39095019293,41605431291,5723741815,16368899324
20099,Staten Island Rapid Transit Operating Authority,Full Reporter: Operating,Urban,8088352,62548663,3631135,9678938,41719214,0,125666302,613404607,0,0,0,149772335,8246453,809043,772232438,897898740,63498657,6220803,5138250,15008761,82237637,108605451,121793785,2334631,1970407,135010518,21152065,61043895,343305301,451910752,26887313,482599332
20100,MTA Long Island Rail Road,Full Reporter: Operating,Urban,184500501,889078409,193990355,291908557,940286903,0,2499764725,20422522264,0,0,0,1102519369,185862356,85708478,21796612467,24296377192,1415593467,965713769,118130295,346745561,165112926,1595702551,2760338491,52618989,44409948,4016865199,230845043,1528209842,8633287512,10228990063,960862123,14522118473
20113,Regional Transit Service,Full Reporter: Operating,Urban,12496984,14850905,542182,983778,77802531,0,106676380,135198106,0,0,0,0,14718428,116078,150032612,256708992,28669067,4837338,0,5517260,18959781,29314379,0,0,0,11208940,129511351,765544,141485835,170800214,32431782,82146063
20188,MTA Bus Company,Full Reporter: Operating,Urban,84453616,610726668,17174812,70514787,442063211,138248981,1363182075,621922783,0,0,0,0,87380681,467697192,1177000656,2540182731,128418430,18064209,131724057,142991980,501597939,794378185,1290545687,24738109,20878739,508138881,1566565867,637033917,4047901200,4842279385,19203797,-2192882021
20223,Cape May Lewes Ferry,Full Reporter: Operating,Urban,276621,312864,3895841,9389,21025525,429173,25949413,209313079,0,0,0,15305364,0,0,224618443,250567856,5431950,6571397,3790300,2040851,3242301,15644849,148909774,0,302910,5441961,0,945751,155600396,171245245,6752476,78002085
30001,Kanawha Valley Regional Transportation Authority,Full Reporter: Operating,Urban,12715026,1307994,629959,0,0,204448,14857427,20588161,0,0,0,152758,630731,0,21371650,36229077,1241961,91639,0,778237,0,869876,0,0,0,2082706,0,0,2082706,2952582,4598567,29919889
30002,The Tri-State Transit Authority,Full Reporter: Operating,Urban,10181925,126505,349974,29022,0,1687055,12374481,30653285,0,0,0,0,0,0,30653285,43027766,1391301,150032,0,327556,0,477588,0,0,0,0,0,0,0,477588,2310856,41630623
30006,Greater Richmond Transit Company,Full Reporter: Operating/Building,Urban,63236747,5349811,1120222,1754045,0,0,71460825,71187659,1446257,0,0,0,0,0,72633916,144094741,29977146,9241080,0,93067,35380032,44714179,0,0,0,68659901,621450,558521,69839872,114554051,23731695,35786141
30007,Greater Roanoke Transit Company,Full Reporter: Operating,Urban,516940,5384658,257576,166698,0,0,6325872,14463651,0,0,0,0,0,0,14463651,20789523,0,7995351,0,520833,902004,9418188,0,0,0,0,0,0,0,9418188,0,11371335
30008,Greater Lynchburg Transit Company,Full Reporter: Operating,Urban,500450,342747,289369,245058,0,0,1377624,34044741,0,0,0,0,0,0,34044741,35422365,188084,692205,0,79081,99840,871126,0,159805,0,0,0,262202,422007,1293133,78203,34239113
30010,Lehigh and Northampton Transportation Authority,Full Reporter: Operating,Urban,22211061,5071042,1085903,718019,0,0,29086025,43990338,0,0,0,0,0,31077882,75068220,104154245,3162511,3870640,1909228,1299676,22144401,29223945,0,0,0,13966222,0,30644509,44610731,73834676,2726669,30755411
30011,Altoona Metro Transit,Full Reporter: Operating,Urban,1657771,2308726,214164,118966,1830292,0,6129919,16237459,0,0,0,0,2000000,0,18237459,24367378,757100,267145,0,396862,7167,671174,0,0,0,0,0,7872370,7872370,8543544,358336,16222598
30012,Cambria County Transit Authority,Full Reporter: Operating,Urban,9547241,3088803,573197,392185,0,0,13601426,50571850,0,0,0,0,0,0,50571850,64173276,178899,1580623,0,283101,0,1863724,0,0,20680,1797712,0,10994022,12812414,14676138,42817,49633220
30013,Erie Metropolitan Transit Authority,Full Reporter: Operating,Urban,21004768,1268985,132896,419499,0,0,22826148,81020698,0,0,0,0,0,307893,81328591,104154739,2605985,870832,0,1789729,18612048,21272609,0,0,0,1496101,0,6040660,7536761,28809370,3021163,74930191
30015,Luzerne County Transportation Authority,Full Reporter: Operating,Urban,6086797,10526911,506783,419873,0,0,17540364,81656515,0,0,0,0,0,0,81656515,99196879,1496507,3912604,0,607006,12522512,17042122,0,0,0,4982058,0,3397053,8379111,25421233,658632,74613521
30019,Southeastern Pennsylvania Transportation Authority,Full Reporter: Operating,Urban,36713547,192213934,102577505,35664821,30909745,778679649,1176759201,4342729577,52944919,0,75224602,421072294,0,2276260,4894247652,6071006853,528533563,127737534,41621518,245767015,660167069,1075293136,795451062,60626862,30097678,974963701,101996379,1236329138,3199464820,4274757956,540748449,1784034011
30022,Pittsburgh Regional Transit,Full Reporter: Operating,Urban,272672311,94185462,22185830,1309918,0,0,390353521,1207646610,0,0,0,0,0,54203901,1261850511,1652204032,228462889,22794073,13875000,23743920,360955310,421368303,97464412,0,0,438010154,0,468451889,1003926455,1425294758,202051514,253320649
30023,Beaver County Transit Authority,Full Reporter: Operating,Urban,11927156,7215271,350832,305367,0,0,19798626,19553147,0,0,0,21986,0,0,19575133,39373759,0,421742,0,439531,0,861273,0,0,0,0,12563,0,12563,873836,17638026,20861897
30025,County of Lackawanna Transit System,Full Reporter: Operating,Urban,3818973,371911,499530,411600,2100291,2304594,9506899,22145237,0,0,0,0,0,0,22145237,31652136,660753,1594392,0,1491341,8031714,11117447,0,0,0,3855198,0,0,3855198,14972645,0,17340244
30026,River Valley Transit Authority,Full Reporter: Operating,Urban,0,0,0,0,0,0,0,0,0,0,0,0,0,0,0,0,0,0,0,0,0,0,0,0,0,0,0,0,0,0,0,0
30030,Washington Metropolitan Area Transit Authority,Full Reporter: Operating,Urban,341824351,271534192,146815598,2325979,78015658,0,840515778,17436450580,105576115,730338173,0,0,0,0,18272364868,19112880646,1281928298,409463162,61395000,490183271,104493524,1065534957,2927951356,54050991,89792867,3369888271,135435224,60629019,6637747728,7703282685,1330989917,11360536342
30035,Ohio Valley Regional Transportation Authority,Full Reporter: Operating,Urban,5850280,1240620,97025,53995,716129,30685,7988734,3173284,0,0,770820,0,0,0,3944104,11932838,582350,0,278973,912109,39139,1230221,0,0,0,0,0,252946,252946,1483167,82197,10949824
30044,Westmoreland County Transit Authority,Full Reporter: Operating,Urban,1708775,903436,367396,215224,0,6624529,9819360,22452592,0,0,0,0,0,0,22452592,32271952,0,2183620,0,286637,307,2470564,0,0,0,0,0,7237182,7237182,9707746,0,22564206
30045,"JAUNT, Inc.",Full Reporter: Operating,Urban,8329320,645093,0,79610,0,0,9054023,4913728,0,0,0,0,0,0,4913728,13967751,0,282812,0,425212,1251371,1959395,0,0,0,0,0,0,0,1959395,0,12008356
30054,Centre Area Transportation Authority,Full Reporter: Operating,Urban,21896547,959965,377788,142861,0,3115193,26492354,52285415,0,0,0,0,0,0,52285415,78777769,0,567811,0,800143,0,1367954,0,0,0,0,0,0,0,1367954,24818219,52591596
30061,Mid Mon Valley Transit Authority,Full Reporter: Operating,Urban,1724361,516066,2500,0,0,1670721,3913648,19825138,18207,0,0,0,0,0,19843345,23756993,0,680329,0,0,1548902,2229231,0,0,0,0,0,0,0,2229231,0,21527762
30070,Potomac and Rappahannock Transportation Commission,Full Reporter: Operating/Building,Urban,13508214,65512632,0,60667,0,17739443,96820956,77131297,0,0,0,0,0,45305,77176602,173997558,523465,16286558,0,463027,36582161,53331746,0,0,0,209195,0,578529,787724,54119470,444620,119956933
30073,Virginia Railway Express,Full Reporter: Operating,Urban,80010886,79540801,3165942,512631,0,60074,163290334,378121946,0,3371175,35423290,121202856,0,1127180,539246447,702536781,1084713,10983399,6720018,4596590,1266371,23566378,159591000,0,3179018,328073,1473173,985190,165556454,189122832,1695668,512802994
30075,Delaware Transit Corporation,Full Reporter: Operating,Urban,21611822,5615913,6837650,1137479,0,0,35202864,168206777,0,0,56310,8206951,9870211,0,186340249,221543113,61034944,6476629,0,6342473,0,12819102,0,2813643,0,179386329,0,2674382,184874354,197693456,114770703,-29886102
30076,Williamsburg Area Transit Authority,Full Reporter: Operating,Urban,4225135,9987,0,0,0,2965127,7200249,10543676,0,0,0,1354189,0,0,11897865,19098114,236670,911040,211966,0,34870,1157876,203505,0,0,0,0,0,203505,1361381,165458,17807945
30083,Transportation District Commission of Hampton Roads,Full Reporter: Operating,Urban,0,60406366,11038282,4966730,423702,0,76835080,229634185,0,0,0,21451506,1000,0,251086691,327921771,19605,10999602,13479525,7656200,77775891,109911218,0,0,37040,8807150,0,4034700,12878890,122790108,25954,205125314
30095,County of Lebanon Transit Authority,Full Reporter: Operating,Urban,6172071,292200,137540,120377,0,0,6722188,6361004,0,0,0,0,0,0,6361004,13083192,0,116801,0,71221,6517552,6705574,0,0,0,0,0,0,0,6705574,0,6377618
30096,The Tri-County Council for the Lower Eastern Shore of Maryland,Full Reporter: Operating,Urban,4536725,0,0,0,0,0,4536725,15995009,0,0,0,0,0,0,15995009,20531734,0,0,0,0,73897,73897,0,0,0,0,0,0,0,73897,0,20457837
30111,Washington County Transportation Authority,Full Reporter: Operating,Urban,7603854,1270632,0,19949,0,0,8894435,10179764,0,0,0,0,0,0,10179764,19074199,0,545559,0,25830,0,571389,0,0,0,0,0,7796518,7796518,8367907,0,10706292
30202,South Central Transit Authority,Full Reporter: Operating,Urban,55414192,5492073,1052283,173742,0,1214460,63346750,91731823,0,0,0,0,0,1940779,93672602,157019352,4493678,1943800,0,1103425,59582014,62629239,0,0,0,4386345,0,315700,4702045,67331284,3674473,90507273
30205,"Transit Management of Central Maryland, Inc.",Full Reporter: Operating,Urban,2402127,196060,299000,57426,0,109730,3064343,119185,0,0,0,0,0,0,119185,3183528,0,616905,0,381042,0,997947,43795,0,0,0,0,0,43795,1041742,0,2141786
30206,Susquehanna Regional Transportation Authority,Full Reporter: Operating,Urban,1594271,22527047,63281,469389,0,0,24653988,5005233,0,0,0,0,0,0,5005233,29659221,0,1682169,0,1468808,21826115,24977092,0,0,0,0,0,0,0,24977092,0,4682129
40004,Metropolitan Transit Authority,Full Reporter: Operating,Urban,4770620,10239550,3670350,1093689,0,0,19774209,164704898,0,0,3,10451608,350000,0,175506509,195280718,33188603,4660628,7000000,7101734,744274,19506636,0,0,0,93806369,0,12657040,106463409,125970045,17981377,84517899
40006,Cape Fear Public Transportation Authority,Full Reporter: Operating,Urban,2289478,425859,360831,0,0,0,3076168,25335436,0,0,0,29883,0,0,25365319,28441487,592207,8943,0,312951,0,321894,0,0,0,808981,0,0,808981,1130875,15265,27887554
40014,Ms Coast Transportation Authority,Full Reporter: Operating,Urban,4834809,1238321,2222572,2487058,0,0,10782760,29565579,0,0,0,1574626,0,0,31140205,41922965,0,1218671,0,326330,0,1545001,0,0,0,0,0,644848,644848,2189849,0,39733116
40017,Lexington Transit Authority,Full Reporter: Operating,Urban,38270317,6484088,834812,27460,0,0,45616677,37464786,0,0,0,0,0,0,37464786,83081463,2472657,871410,0,878826,0,1750236,0,0,0,0,0,0,0,1750236,747248,83056636
40018,Transit Authority of River City,Full Reporter: Operating,Urban,12372983,6305571,2267929,222571,0,0,21169054,79709248,0,0,0,0,0,0,79709248,100878302,19255056,10796671,0,6262883,1667124,18726678,0,0,0,84742061,3387907,23029818,111159786,129886464,14918124,-24671230
40019,Transit Authority of Northern Kentucky,Full Reporter: Operating,Urban,442568,80026,722496,146821,10535703,748,11928362,30652175,0,0,0,443755,313000,0,31408930,43337292,1150000,1328275,0,310445,107247,1745967,0,57760,0,13297058,391000,1573938,15319756,17065723,1850000,25571569
40022,Metropolitan Atlanta Rapid Transit Authority,Full Reporter: Operating,Urban,69593002,83127229,39924452,6431794,821744118,176442075,1197262670,2633773288,0,284947581,0,416148465,42092293,7524497,3384486124,4581748794,174798487,136230451,0,32893869,126691738,295816058,2169821413,0,29548068,153352344,0,126571469,2479293294,2775109352,325743691,1655694238
40025,Chatham Area Transit Authority,Full Reporter: Operating,Urban,7679017,11657874,895205,114348,8073731,0,28420175,47972945,0,0,0,0,0,0,47972945,76393120,161916,273368,0,281674,903998,1459040,0,0,0,816811,0,61000,877811,2336851,391576,73826609
40027,Pinellas Suncoast Transit Authority,Full Reporter: Operating/Building,Urban,56511207,10006384,3777311,644965,0,447649,71387516,128419989,0,0,0,0,0,1520045,129940034,201327550,12337513,5815653,0,5503877,344540,11664070,0,0,0,50217328,10117440,4209570,64544338,76208408,4893429,132563226
40031,Lakeland Area Mass Transit District ,Full Reporter: Operating,Urban,1230016,5235812,419441,345678,5401221,0,12632168,14350270,0,0,0,59859,1503150,0,15913279,28545447,2045027,651881,231405,134144,155996,1173426,0,0,441353,9224307,0,538820,10204480,11377906,715932,18496636
40035,Central Florida Regional Transportation Authority,Full Reporter: Operating,Urban,118751675,29142053,3516698,387405,0,1400751,153198582,148397308,0,4028953,0,5323277,9335199,0,167084737,320283319,30109216,15466230,10438842,1594245,16011207,43510524,0,0,2681738,28703179,7376504,0,38761421,82271945,1810208,266310382
40040,Jacksonville Transportation Authority,Full Reporter: Operating,Urban,12463499,5961325,3433807,1202586,0,18168680,41229897,169709647,0,0,0,144832269,0,25994476,340536392,381766289,6288605,21109364,0,1890507,177396,23177267,0,0,0,0,83554,5274293,5357847,28535114,6935161,352584619
40041,Hillsborough Area Regional Transit Authority,Full Reporter: Operating,Urban,40658628,34522708,2499690,509617,0,0,78190643,98153979,0,1613457,0,4752207,0,0,104519643,182710286,13613246,13384434,17243,2634485,3889069,19925231,0,0,0,62797597,6642802,0,69440399,89365630,2453616,104504286
40042,Birmingham-Jefferson County Transit Authority,Full Reporter: Operating,Urban,15515522,6205199,1275270,352653,0,0,23348644,69880849,0,0,0,721562,0,10950,70613361,93962005,1640843,2996091,2550000,662879,1084302,7293272,2553173,0,0,23493343,0,0,26046516,33339788,6522925,55740135
40053,Greenville Transit Authority,Full Reporter: Operating,Urban,6307904,2670426,475556,130321,0,0,9584207,9177736,0,0,0,19071187,0,0,28248923,37833130,0,3699885,0,0,726,3700611,0,0,0,0,0,633070,633070,4333681,126210,33373239
40057,Jackson Transit Authority,Full Reporter: Operating,Urban,60316,149752,92971,119063,0,0,422102,7736501,0,0,0,0,0,0,7736501,8158603,1056714,62294,0,96951,534411,693656,0,0,0,279426,0,0,279426,973082,1405827,6836408
40077,South Florida Regional Transportation Authority,Full Reporter: Operating,Urban,81598604,52299732,0,2246549,0,0,136144885,554602222,0,0,0,0,0,0,554602222,690747107,2695091,18460999,0,1752491,4806458,25019948,27361307,0,0,8660116,0,5359325,41380748,66400696,1590566,625450936
40086,Metropolitan Bus Authority,Full Reporter: Operating,Urban,48537301,26333570,8356129,0,0,0,83227000,35114091,0,0,0,0,0,0,35114091,118341091,41505009,71271543,2255,12833924,0,84107722,274705078,0,0,1237446,0,2089875,278032399,362140121,19292704,-221586725
40100,Santee Wateree Regional Transportation Authority,Full Reporter: Operating,Urban,54042,461791,0,31000,0,0,546833,14992186,0,0,190822,0,0,0,15183008,15729841,1566341,301778,0,0,0,301778,254198,0,0,0,0,0,254198,555976,770896,15969310
40108,Research Triangle Regional Public Transportation Authority,Full Reporter: Operating,Urban,43838763,67876276,1438971,73815,680270001,2289675,795787501,61443016,0,0,0,0,0,28725744,90168760,885956261,1138818,11005198,1149222,0,17619,12172039,5802194,0,0,0,0,0,5802194,17974233,2416275,866704571
40110,Charleston Area Regional Transportation Authority,Full Reporter: Operating,Urban,9017887,7076870,71691,409407,0,0,16575855,44252408,0,0,0,0,0,0,44252408,60828263,0,1843783,0,0,106252,1950035,1369641,0,0,134964,0,0,1504605,3454640,0,57373623
40141,Central Midlands Regional Transportation Authority,Full Reporter: Operating,Urban,2040468,10871490,105347,140423,41110962,14954,54283644,26205110,0,0,0,0,2644838,0,28849948,83133592,553267,3825854,0,50714,80238,3956806,0,0,0,2236464,0,24200,2260664,6217470,80235,77389154
40159,Regional Transportation Authority,Full Reporter: Operating,Urban,8849035,975539,364480,23994,0,0,10213048,40129949,0,0,0,0,0,0,40129949,50342997,0,713987,0,25996,5433831,6173814,0,0,0,0,0,0,0,6173814,0,44169183
40172,Western Piedmont Regional Transit Authority ,Full Reporter: Operating,Urban,2721329,5375564,0,29708,0,1314,8127915,2854075,194556,0,0,0,0,0,3048631,11176546,649971,181887,0,74691,114240,370818,0,0,0,411617,0,215379,626996,997814,641196,10187507
40173,Piedmont Authority for Regional Transportation,Full Reporter: Operating,Urban,21506398,1443273,0,42737,0,0,22992408,25261926,0,0,0,0,0,0,25261926,48254334,0,595506,0,0,135470,730976,0,0,0,0,0,158448,158448,889424,0,47364910
40191,Transit Authority of Central Kentucky,Full Reporter: Operating,Urban,2801989,538965,0,0,0,0,3340954,5747783,0,0,0,0,0,0,5747783,9088737,0,108002,0,144444,49357,301803,0,0,0,0,0,9088738,9088738,9390541,0,-301804
40200,Tampa Bay Area Regional Transit Authority,Full Reporter: Operating,Urban,608236,345241,0,0,0,0,953477,18553,0,0,0,0,0,0,18553,972030,0,104297,0,15270,0,119567,0,0,0,0,0,0,0,119567,0,852463
40244,"Spartanburg Regional Health Services, Inc.",Full Reporter: Operating,Urban,0,0,0,0,0,0,0,0,0,0,0,0,0,0,0,0,0,0,0,0,0,0,0,0,0,0,0,0,0,0,0,0
40950,First Tennessee Human Resource Agency,Full Reporter: Operating,Urban,8066915,1457148,0,2162,0,0,9526225,517759,0,0,0,0,0,0,517759,10043984,0,1316107,0,0,0,1316107,0,0,0,0,0,0,0,1316107,0,8727877
50010,METRO Regional Transit Authority ,Full Reporter: Operating,Urban,152440659,17314652,1471906,1628483,0,0,172855700,55365545,0,0,0,2872145,0,0,58237690,231093390,22317064,1727482,0,3389620,279171,5396273,0,0,0,47452831,73333,0,47526164,52922437,845362,199642655
50011,Stark Area Regional Transit Authority,Full Reporter: Operating,Urban,8477306,349360,283360,331934,1005132,4922613,15369705,41777016,1949759,0,0,21544759,0,1097787,66369321,81739026,12205415,1006939,0,2843131,0,3850070,0,0,0,0,0,0,0,3850070,288529,89805842
50012,Southwest Ohio Regional Transit Authority,Full Reporter: Operating,Urban,1816675,47392513,2089692,1808214,162785541,0,215892635,114087057,7695044,0,0,22835852,115669105,866703,261153761,477046396,66483590,15604991,0,12732304,5135885,33473180,0,4022686,7450162,129994857,0,1217100,142684805,176157985,1059368,366312633
50015,The Greater Cleveland Regional Transit Authority,Full Reporter: Operating,Urban,33886094,78166123,21280386,0,172694551,1565404,307592558,569127474,0,0,93712882,197666798,70450350,3589651,934547155,1242139713,127688924,17952507,7995000,28272709,10000,54230216,27369203,0,0,280312696,0,18272228,325954127,380184343,2011120,987633174
50016,Central Ohio Transit Authority,Full Reporter: Operating/Building,Urban,308737681,58329117,5379098,2011385,0,0,374457281,250339761,0,0,0,105522356,1167539,0,357029656,731486937,66379397,8066122,0,12021244,4046678,24134044,30000000,2068504,16000,139981032,1210726,0,173276262,197410306,6258933,594197095
50017,Greater Dayton Regional Transit Authority,Full Reporter: Operating,Urban,18071933,19709832,7978214,2683599,27387926,0,75831504,157645969,0,0,0,44093830,64139376,0,265879175,341710679,27333870,3433409,0,12130644,1893089,17457142,0,0,0,57199568,0,2562050,59761618,77218760,4037743,287788046
50021,Portage Area Regional Transportation Authority,Full Reporter: Operating,Urban,5813716,2433828,285477,263182,0,0,8796203,27837691,0,0,12054523,0,0,0,39892214,48688417,4620738,155783,0,330638,1669,488090,0,0,0,9520225,227997,0,9748222,10236312,141368,42931475
50022,Toledo Area Regional Transit Authority,Full Reporter: Operating,Urban,31257140,9613265,2185566,143870,20680285,0,63880126,33949937,0,0,0,0,0,0,33949937,97830063,12446065,3307992,0,1367272,188861,4864125,0,0,0,25551547,0,542852,26094399,30958524,223675,79093929
50024,Western Reserve Transit Authority,Full Reporter: Operating,Urban,18258620,5802108,529655,1039600,9092481,147710,34870174,25132738,0,0,0,0,0,11000,25143738,60013912,6651625,73260,0,1302825,0,1376085,0,0,147710,809078,0,14652982,15609770,16985855,121131,49558551
50025,Duluth Transit Authority,Full Reporter: Operating,Urban,10849540,121738,561046,14397,0,5145247,16691968,44157753,0,0,0,0,0,0,44157753,60849721,0,1325656,0,1013148,183976,2522780,0,0,0,0,0,0,0,2522780,0,58326941
50027,Metro Transit ,Full Reporter: Operating,Urban,563896591,27237365,28381528,2104630,0,716043669,1337663783,1679525113,0,11911629,130243788,2554566120,0,433638,4376680288,5714344071,118938568,223620427,0,8592977,88807439,321020843,216632000,1060855,11260903,76739002,292992287,0,598685047,919705890,171467344,4742109405
50028,St. Cloud Metropolitan Transit Commission,Full Reporter: Operating,Urban,15730459,3052935,331718,9164,0,0,19124276,26229677,0,0,7558795,0,0,0,33788472,52912748,1565849,817674,0,554364,0,1372038,0,0,0,5401463,852424,0,6253887,7625925,184697,46667975
50029,Bay Metropolitan Transit Authority,Full Reporter: Operating,Urban,6289374,784025,223094,54909,0,0,7351402,4320710,0,0,0,154022,0,104519,4579251,11930653,4011121,110004,0,681420,0,791424,0,0,0,8342956,0,0,8342956,9134380,178566,6628828
50031,Suburban Mobility Authority for Regional Transportation,Full Reporter: Operating,Urban,170036384,31307873,3362054,443398,16839043,0,221988752,154162366,5000,0,0,0,0,583647,154751013,376739765,35940224,8686427,0,12195265,9182665,30064357,0,0,0,94650308,10669415,771392,106091115,136155472,50340231,226184286
50032,Mass Transportation Authority ,Full Reporter: Operating,Urban,16806221,11686802,1973551,97486,0,0,30564060,58400362,0,0,0,0,0,896781,59297143,89861203,244511,2932103,573856,607803,908627,5022389,3636334,52560,0,0,1166698,0,4855592,9877981,1217125,79010608
50033,Interurban Transit Partnership,Full Reporter: Operating,Urban,75924629,1763040,747054,1354706,0,8252087,88041516,145359148,1077359,0,0,1958118,0,0,148394625,236436141,953056,5457217,0,2029206,1896215,9382638,0,0,0,1146920,0,0,1146920,10529558,22107577,204752062
50034,City of Jackson Transportation Authority,Full Reporter: Operating,Urban,2859816,253312,374127,27849,108393,0,3623497,3055926,0,0,0,0,0,0,3055926,6679423,1355354,42016,0,61273,247141,350430,0,0,0,4120342,0,16747,4137089,4487519,0,3547258
50035,Central County Transportation Authority,Full Reporter: Operating,Urban,9566653,7508230,693423,271644,1008050,0,19048000,23774499,45972,0,36843453,454503,0,0,61118427,80166427,5721643,767392,105462,742320,1745940,3361114,3546828,0,0,1894871,53797,100022,5595518,8956632,517325,76414113
50036,Capital Area Transportation Authority,Full Reporter: Operating,Urban,3578272,12620536,1596805,912277,25476388,0,44184278,47857432,0,0,0,6880621,0,0,54738053,98922331,29879354,1621967,0,3226600,795450,5644017,0,0,0,0,0,55126260,55126260,60770277,32916564,35114844
50039,Saginaw Transit Authority Regional Service,Full Reporter: Operating,Urban,1848149,1296958,349738,198545,0,0,3693390,10099379,173458,0,0,0,0,0,10272837,13966227,337332,397154,210178,264173,160972,1032477,0,0,189614,0,0,102965,292579,1325056,337332,12641171
50040,Ann Arbor Area Transportation Authority,Full Reporter: Operating,Urban,54630107,8381539,1380675,2104445,0,0,66496766,40768622,0,0,56322,356753,0,0,41181697,107678463,148237,3502966,0,2057499,107689,5668154,0,0,0,0,0,0,0,5668154,649075,101509471
50044,Fort Wayne Public Transportation Corporation,Full Reporter: Operating,Urban,2843777,1865479,629610,139589,0,0,5478455,15019666,0,0,1231337,0,0,2167,16253170,21731625,8702730,315047,0,1229597,106631,1651275,0,0,0,16228160,236119,5660987,22125266,23776541,4806265,1851549
50045,Gary Public Transportation Corporation,Full Reporter: Operating,Urban,590347,25272,295195,102610,0,3410778,4424202,3444842,0,0,0,0,0,0,3444842,7869044,0,200312,0,0,0,200312,0,0,0,0,0,0,0,200312,1556108,6112624
50047,Bloomington-Normal Public Transit System,Full Reporter: Operating,Urban,6171244,5336344,385638,395339,0,0,12288565,30997595,0,0,0,0,0,425536,31423131,43711696,0,963330,0,192143,944539,2100012,0,0,0,0,0,712168,712168,2812180,0,40899516
50050,Indianapolis and Marion County Public Transportation,Full Reporter: Operating,Urban,131501094,35292570,3232872,277021,148926871,0,319230428,364746069,0,0,0,168520085,0,18890993,552157147,871387575,0,33994625,6718199,2140141,339264,43192229,96751893,0,0,553672,0,4639801,101945366,145137595,134478,726115502
50051,Greater Lafayette Public Transportation Corporation,Full Reporter: Operating,Urban,8753638,4863423,471454,182736,0,0,14271251,25254723,0,0,1552685,1086114,0,0,27893522,42164773,1706338,1092447,10000,650695,12941,1766083,0,0,0,3906652,0,0,3906652,5672735,3410670,34787706
50052,South Bend Public Transportation Corporation,Full Reporter: Operating,Urban,934422,840419,381668,110130,0,0,2266639,69590573,0,0,0,549281,0,0,70139854,72406493,0,89655,0,0,1164224,1253879,0,0,0,910572,0,0,910572,2164451,974815,69267227
50054,Muncie Indiana Transit System,Full Reporter: Operating,Urban,4891411,1130,447569,146790,0,0,5486900,10162607,0,0,0,0,0,0,10162607,15649507,895633,105020,0,58312,0,163332,0,0,2170,1911487,0,0,1913657,2076989,491854,13976297
50056,Greater Peoria Mass Transit District,Full Reporter: Operating,Urban,26564031,27937222,598799,1351856,226785,0,56678693,43816517,0,0,0,0,0,0,43816517,100495210,12452294,12366176,0,3674603,0,16040779,0,0,0,0,16352295,0,16352295,32393074,11556271,68998159
50057,Rock Island County Metropolitan Mass Transit District,Full Reporter: Operating,Urban,9151232,5445227,17233,1090411,0,0,15704103,86003601,0,810921,0,0,0,7746075,94560597,110264700,1111244,1644570,0,650426,1606360,3901356,0,0,831529,0,131532,0,963061,4864417,5966088,100545439
50058,Rockford Mass Transit District,Full Reporter: Operating,Urban,5271078,5305105,640229,225073,0,0,11441485,39318338,0,0,0,0,0,0,39318338,50759823,2233785,520995,0,2367387,0,2888382,0,0,0,5568641,0,6923749,12492390,15380772,64819,37548017
50059,Springfield Mass Transit District,Full Reporter: Operating,Urban,7942127,4215641,946882,53414,0,289634,13447698,22292943,0,0,0,1314350,1491023,0,25098316,38546014,6147835,569231,0,1298596,0,1867827,2168311,0,0,0,0,9352354,11520665,13388492,1257829,30047528
50060,Champaign-Urbana Mass Transit District,Full Reporter: Operating,Urban,7022884,17612268,1780525,1498807,0,0,27914484,78715674,1574401,0,40130192,9801849,0,0,130222116,158136600,11305725,4321354,641214,8330562,2500472,15793602,546340,0,0,18058143,227216,0,18831699,34625301,2166688,132650336
50066,Chicago Transit Authority,Full Reporter: Operating,Urban,136326482,626154793,22458892,5844399,0,0,790784566,4443410784,0,0,525017968,803581969,20510876,11400057,5803921654,6594706220,399958286,356442200,146458134,197907706,265535474,966343514,4619644672,0,45822283,2054638917,204229906,20000,6924355778,7890699292,14750434,-910785220
50104,Northern Indiana Commuter Transportation District,Full Reporter: Operating,Urban,7495524,220169303,6966024,3587370,2332493,0,240550714,316846878,0,0,77560388,1176371305,344989,0,1571123560,1811674274,531159,195301963,2695000,7734774,3590984,209322721,155263963,0,0,652927,0,0,155916890,365239611,3938839,1443026983
50110,Bloomington Public Transportation Corporation,Full Reporter: Operating,Urban,16051688,297669,325573,56389,0,1833179,18564498,15302816,0,0,0,0,0,0,15302816,33867314,1061549,210253,0,508714,0,718967,0,0,0,2324419,0,0,2324419,3043386,1621988,30263489
50113,"Pace, the Suburban Bus Division of the Regional Transportation Authority",Full Reporter: Operating,Urban,167341924,90227539,13213150,2292432,103463937,1122899,377661881,339926810,0,0,773513,26814512,0,0,367514835,745176716,52834181,15799290,2205530,19302494,4640167,41947481,1681810,295920,0,66296375,34989697,29177581,132441383,174388864,8411800,615210233
50117,Laketran,Full Reporter: Operating,Urban,31349051,25323423,781881,207668,27811380,0,85473403,37193407,0,0,358093,9374749,0,2435059,49361308,134834711,2575778,1258846,0,2616590,0,3875436,0,0,0,54201257,0,0,54201257,58076693,24798969,54534827
50118,Northeast Illinois Regional Commuter Railroad Corporation,Full Reporter: Operating,Urban,59882413,306154612,36554928,15404223,119460350,0,537456526,3077195912,0,115756033,0,338123481,13788100,9730043,3554593569,4092050095,93572869,80081,0,198586997,0,198667078,0,0,0,92228472,199778567,0,292007039,490674117,39858707,3655090140
50141,Detroit Transportation Corporation,Full Reporter: Operating,Urban,82936,4489743,3212226,851591,0,0,8636496,21429578,0,0,1198191,1882141,4401909,0,28911819,37548315,2638647,1128332,0,184761,2926294,4239387,0,0,0,2737827,200000,435496,3373323,7612710,5753585,26820667
50146,Madison County Transit District,Full Reporter: Operating,Urban,334489,10583179,1225563,1321634,22925359,0,36390224,69440957,0,0,0,0,39930000,0,109370957,145761181,0,4876069,0,0,0,4876069,0,0,0,0,0,0,0,4876069,0,140885112
50148,Blue Water Area Transportation Commission,Full Reporter: Operating,Urban,11244373,5587201,904653,368829,0,0,18105056,30539793,0,0,0,95560,0,0,30635353,48740409,3529884,672202,0,664947,277781,1614930,0,0,0,4904653,0,27952,4932605,6547535,36387,45686371
50157,Butler County Regional Transit Authority,Full Reporter: Operating,Urban,8132177,2169156,81308,292351,0,0,10674992,16818398,550504,0,0,1784570,0,23736,19177208,29852200,3392566,543329,0,341357,102099,986785,0,0,0,6687240,0,311829,6999069,7985854,52013,25206899
50182,"Pace, the Suburban Bus Division of the Regional Transportation Authority",Full Reporter: Operating,Urban,40471796,990737,0,1122655,0,0,42585188,13626744,0,0,0,0,0,0,13626744,56211932,5320619,9619274,0,30606056,2751780,42977110,0,217,0,4375277,262098,0,4637592,47614702,291105,13626744
50184,Macatawa Area Express Transportation Authority,Full Reporter: Operating,Urban,4779805,528104,0,118790,0,0,5426699,8449079,0,0,0,0,0,0,8449079,13875778,0,198095,0,258673,0,456768,0,0,364079,0,0,0,364079,820847,0,13054931
50199,Delaware County Transit Board,Full Reporter: Operating,Urban,5864409,1464306,0,89008,0,0,7417723,7223564,0,0,0,0,0,102278,7325842,14743565,1793652,102278,0,218057,44146,364481,0,3441102,0,0,0,0,3441102,3805583,45441,12686193
50209,Central Indiana Regional Transportation Authority ,Full Reporter: Operating,Urban,313007,0,0,0,0,0,313007,0,0,0,0,0,0,0,0,313007,0,0,0,0,0,0,0,0,0,0,0,0,0,0,0,313007
50212,Stateline Mass Transit District,Separate Service,Urban,717510,375282,0,0,0,0,1092792,71736,0,0,0,0,0,0,71736,1164528,0,174522,0,0,0,174522,0,0,0,0,0,0,0,174522,0,990006
50518,SouthWest Transit,Full Reporter: Operating,Urban,4027100,1162604,203860,135869,8869036,0,14398469,41303142,0,0,7940544,0,0,0,49243686,63642155,632774,1029330,0,113273,161624,1304227,0,27388,0,1918018,0,167807,2113213,3417440,620410,60237079
50519,Minnesota Valley Transit Authority,Full Reporter: Operating,Urban,12881109,3531840,78027,441852,1469081,0,18401909,37147571,0,0,0,16387825,0,0,53535396,71937305,576368,4088541,0,168109,63244,4319894,1640849,0,0,1806180,410750,0,3857779,8177673,1985496,62350504
50522,Lake Erie Transportation Commission,Full Reporter: Operating,Urban,1863807,33373,360092,118279,0,1346867,3722418,224311,0,0,0,0,5701383,0,5925694,9648112,0,24783,101566,84333,107909,318591,0,5401,0,0,0,95795,101196,419787,0,9228325
60007,Fort Worth Transportation Authority,Full Reporter: Operating,Urban,38950448,48901005,8685885,2379544,0,0,98916882,1038579236,16913075,0,0,45419770,0,0,1100912081,1199828963,0,17444787,743120,2881127,3308514,24377548,0,0,0,0,0,25354518,25354518,49732066,0,1150096897
60008,"Metropolitan Transit Authority of Harris County, Texas ",Full Reporter: Operating,Urban,39811604,189995747,56082186,0,834463453,0,1120352990,2504268241,0,0,93235578,90767925,0,7331831,2695603575,3815956565,203685324,70729327,65355000,56055044,21704730,213844101,848219472,0,38172255,922408890,0,11286273,1820086890,2033930991,241065102,1744645796
60011,VIA Metropolitan Transit,Full Reporter: Operating,Urban,100553327,92582360,8750407,38662,337287993,0,539212749,397414289,0,0,2980776,38546208,0,0,438941273,978154022,71756956,30027763,11095000,24082744,8805040,74010547,159931930,0,4218873,209607805,0,0,373758608,447769155,5771687,596370136
60022,Capital Area Transit System,Full Reporter: Operating,Urban,27834481,23831349,1049348,557720,0,247417,53520315,56098569,0,0,0,0,0,0,56098569,109618884,2578254,2869413,0,1782972,740213,5392598,0,0,161793,0,447261,0,609054,6001652,0,106195486
60032,New Orleans Regional Transit Authority,Full Reporter: Operating,Urban,59313496,60816858,861139,4100503,4230689,0,129322685,243996454,0,0,0,44954362,1415000,26291515,316657331,445980016,341957,4021720,1407350,971092,24287586,30687748,26135393,0,0,22956147,0,0,49091540,79779288,2138482,364404203
60033,Rock Region Metropolitan Transit Authority,Full Reporter: Operating,Urban,13151288,886553,546283,141979,0,0,14726103,46352763,0,0,0,213952,0,0,46566715,61292818,0,400157,0,1153575,7259,1560991,0,0,0,0,0,0,0,1560991,0,59731827
60048,Capital Metropolitan Transportation Authority,Full Reporter: Operating,Urban,175834518,69787519,11654109,534208,169320321,65597587,492728262,407905025,0,75638816,0,249381798,66814836,0,799740475,1292468737,19836435,10310515,0,69060220,5881296,85252031,0,0,9932475,50535044,0,3090934,63558453,148810484,88610027,1074884661
60051,Corpus Christi Regional Transportation Authority,Full Reporter: Operating,Urban,21942551,11266790,757581,828020,31091860,0,65886802,79261504,0,1481296,0,1094110,2000000,0,83836910,149723712,11045444,3223203,930000,5925146,493176,10571525,15855000,0,338738,11426175,0,1868928,29488841,40060366,5117108,115591682
60056,Dallas Area Rapid Transit,Full Reporter: Operating,Urban,135133253,188220566,41325176,9578237,790481430,8523584,1173262246,3196838519,0,0,22994889,1263991388,0,140437790,4624262586,5797524832,36659060,168240106,111061455,0,132662731,411964292,3594205530,45854317,12328391,58991000,0,0,3711379238,4123343530,56828671,1654011691
60059,Brazos Transit District,Full Reporter: Operating,Urban,4724488,238849,98552,0,0,0,5061889,57365753,0,0,0,0,0,0,57365753,62427642,17420,695111,0,2537356,0,3232467,0,0,0,0,0,0,0,3232467,0,59212595
60091,Hill Country Transit District,Full Reporter: Operating,Urban,8534875,3801442,207003,155626,0,0,12698946,8148158,0,0,0,0,0,0,8148158,20847104,0,146785,0,339276,0,486061,0,0,0,0,0,5095090,5095090,5581151,0,15265953
60101,Denton County Transportation Authority,Full Reporter: Operating,Urban,84627740,10990140,861479,143063,25880573,0,122502995,264684647,17394147,0,127525,4202668,0,675203,287084190,409587185,449852,3882789,2785000,829462,1803941,9301192,15225000,0,0,0,0,500000,15725000,25026192,134996,384875849
60102,Concho Valley Transit District,Full Reporter: Operating,Urban,1092594,746386,0,0,0,0,1838980,14133666,0,0,161715,0,0,0,14295381,16134361,0,419690,0,0,0,419690,0,0,0,0,0,0,0,419690,113486,15601185
60111,Rio Metro Regional Transit District,Full Reporter: Operating,Urban,48680968,24348265,0,0,0,0,73029233,7336341,1174941,0,0,0,90000,0,8601282,81630515,0,11406642,683921,0,163653,12254216,9538931,0,1169942,0,0,0,10708873,22963089,0,58667426
60114,STAR Transit,Full Reporter: Operating,Urban,1022487,1058234,6957,350,0,0,2088028,6678692,0,0,0,0,0,0,6678692,8766720,0,161748,0,298050,0,459798,0,0,0,0,0,0,0,459798,0,8306922
60276,"Plaquemines Port, Harbor and Terminal District",Full Reporter: Operating,Urban,0,0,0,0,0,0,0,0,0,0,0,0,0,0,0,0,0,0,0,0,0,0,0,0,0,0,0,0,0,0,0,0
70002,Transit Authority of Omaha,Full Reporter: Operating,Urban,9249279,44275449,1803555,383408,10043909,0,65755600,49064972,892994,0,68977,1734780,0,0,51761723,117517323,4874071,1831052,101827,2510144,0,4443023,81113,0,0,14436988,4747409,236144,19501654,23944677,3863364,94583353
70005,Kansas City Area Transportation Authority,Full Reporter: Operating,Urban,13646322,22865364,1925349,1222406,975000,98954,40733395,128093780,0,135620,45570939,0,0,0,173800339,214533734,11395057,4660349,9000000,5259075,3643036,22562460,0,0,9998,29555691,6595855,0,36161544,58724004,14067946,153136841
70006,Bi-State Development Agency of the Missouri-Illinois Metropolitan District,Full Reporter: Operating,Urban,313467494,51704585,15294494,391402,162221680,0,543079655,673998235,0,0,0,46562316,191990002,18574482,931125035,1474204690,37451527,16429769,14460000,18179900,3855893,52925562,472629642,0,152237002,107739727,0,49525929,782132300,835057862,21341666,655256689
70010,Des Moines Area Regional Transit Authority,Full Reporter: Operating,Urban,32303741,30119963,897822,459029,0,0,63780555,48770833,0,0,0,6214772,0,253759,55239364,119019919,10991577,719856,747564,1525132,1245132,4237684,0,0,3066288,8225598,0,0,11291886,15529570,36619740,77862186
70014,Topeka Metropolitan Transit Authority,Full Reporter: Operating,Urban,9029027,771940,46320,231015,0,0,10078302,10624013,0,0,13171794,778497,0,0,24574304,34652606,1028627,75415,0,273609,24175,373199,0,0,0,2659991,0,126792,2786783,3159982,1209943,31311308
70057,Loop Trolley Transportation Development District,Full Reporter: Operating,Urban,448426,0,0,0,0,0,448426,0,0,0,0,0,0,0,0,448426,0,0,0,0,0,0,0,0,0,0,0,0,0,0,0,448426
70066,Heart of Iowa Regional Transit Agency,Full Reporter: Operating,Urban,4036799,675175,0,0,0,0,4711974,1710790,0,0,0,0,0,0,1710790,6422764,10928,211729,0,0,0,211729,0,0,0,0,0,0,0,211729,33430,6188533
80001,Utah Transit Authority,Full Reporter: Operating,Urban,294285844,119548812,44517295,1889532,221460199,0,681701682,2644767203,82205962,0,0,188838231,107155722,51927513,3074894631,3756596313,95889907,48759625,79821083,14055013,98271933,240907654,2158463302,52885000,0,142283669,0,23241235,2376873206,2617780860,7541486,1227163874
80006,Denver Regional Transportation District,Full Reporter: Operating,Urban,625550796,205074769,40787935,8113116,111794618,1655000,992976234,5645600156,0,0,0,81040967,545384600,50530379,6322556102,7315532336,112980491,57100593,70490741,51299177,19184981,198075492,2765524357,0,0,227392085,0,558545076,3551461518,3749537010,101450266,3577525551
80009,Missoula Urban Transportation District,Full Reporter: Operating,Urban,29170490,294738,325128,32289,0,0,29822645,16370398,0,0,0,0,0,0,16370398,46193043,0,685437,0,306039,0,991476,0,0,0,0,0,713295,713295,1704771,0,44488272
80012,Great Falls Transit District,Full Reporter: Operating,Urban,7605406,1568492,194655,390517,0,0,9759070,5113299,0,0,17500,0,0,0,5130799,14889869,0,9244,0,401796,13780,424820,0,0,0,0,0,0,0,424820,0,14465049
80028,Cache Valley Transit District,Full Reporter: Operating,Urban,12278646,2335672,71000,95279,0,0,14780597,37623016,0,0,0,0,0,0,37623016,52403613,0,1097672,0,854891,387000,2339563,0,0,0,0,0,167000,167000,2506563,0,49897050
90001,Regional Transportation Commission of Washoe County,Full Reporter: Operating,Urban,54791583,19387119,169587,625554,0,3875071,78848914,102896222,0,0,0,0,0,0,102896222,181745136,0,6078804,0,0,5681897,11760701,0,4619100,0,5901748,0,0,10520848,22281549,0,159463587
90003,San Francisco Bay Area Rapid Transit District,Full Reporter: Operating,Urban,69633174,437376466,79969827,18040322,846672915,4470291,1456162995,9152278633,0,88393086,770073253,1780536452,0,14592176,11805873600,13262036595,696770711,226906782,73975000,111803878,51689802,464375462,3248323548,116687212,62310983,1269940995,60815615,3747388,4761825741,5226201203,489257731,8243348372
90004,Golden Empire Transit District,Full Reporter: Operating,Urban,16471681,6928310,1336775,271634,0,0,25008400,54138666,0,0,0,0,0,0,54138666,79147066,0,1304183,0,1786952,0,3091135,0,0,0,0,6188290,7823344,14011634,17102769,0,62044297
90006,Santa Cruz Metropolitan Transit District,Full Reporter: Operating,Urban,68722082,7126622,1038476,825703,0,13464039,91176922,84044920,0,0,19030989,11435917,0,174585,114686411,205863333,27104274,7699527,3414206,4673004,1053369,16840106,0,16332110,0,162501116,5364796,0,184198022,201038128,38139100,-6209621
90009,San Mateo County Transit District,Full Reporter: Operating/Building,Urban,318713479,141051250,2053595,2219792,63703289,21295,527762700,142457250,0,0,0,11104645,154470105,0,308032000,835794700,56302231,15476405,11825000,17718576,25809887,70829868,159620946,0,0,108616597,12466713,0,280704256,351534124,83900057,456662750
90012,San Joaquin Regional Transit District,Full Reporter: Operating/Building,Urban,49044142,16589799,1903932,434916,0,13260,67986049,105122687,0,0,18292537,0,0,0,123415224,191401273,10887624,2286183,2000000,2375129,3067183,9728495,1800000,0,0,0,33953000,22838752,58591752,68320247,4012337,129956313
90013,Santa Clara Valley Transportation Authority,Full Reporter: Operating,Urban,168368000,113273000,29139000,6618000,1059424000,0,1376822000,4023874000,0,0,0,1248018000,0,111043000,5382935000,6759757000,124374000,33370000,17805000,8620000,97202000,156997000,80995000,1741000,0,405473000,0,0,488209000,645206000,50297000,6188628000
90014,Alameda-Contra Costa Transit District,Full Reporter: Operating,Urban,248793866,71892491,18568790,15516511,40017969,0,394789627,393824952,0,0,0,49084932,0,0,442909884,837699511,179418937,19217129,10044537,52219565,141873,81623104,8181480,0,0,556606771,81907373,0,646695624,728318728,89790691,199009029
90016,"Golden Gate Bridge, Highway and Transportation District",Full Reporter: Operating,Urban,5273,14893090,4830583,801176,0,0,20530122,162864189,0,0,0,67702801,0,0,230566990,251097112,52051409,3494785,0,3209029,12946455,19650269,67660,0,0,163114000,16990427,0,180172087,199822356,3213000,100113165
90019,Sacramento Regional Transit District,Full Reporter: Operating,Urban,59559416,63707285,18133450,603385,39418694,0,181422230,663126731,70688720,0,63597324,144856767,24731302,0,967000844,1148423074,73966655,30602668,1592654,26921324,6462094,65578740,43806597,0,60910135,160978977,20345237,17310582,303351528,368930268,16428430,837031031
90020,Santa Barbara Metropolitan Transit District,Full Reporter: Operating,Urban,7660330,9968302,1110919,428211,0,0,19167762,31240507,1083485,0,2799715,2559384,0,0,37683091,56850853,660511,691772,0,956289,1212255,2860316,0,713239,818513,1818431,3288266,2876916,9515365,12375681,289779,44845904
90023,Long Beach Transit,Full Reporter: Operating,Urban,52433805,13189672,3760094,1233619,0,0,70617190,96190311,10807834,0,0,17918054,15912334,2779578,143608111,214225301,11915316,7880472,0,1552984,64712697,74146153,0,9958403,0,34055081,5947068,3286334,53246886,127393039,3178028,95569550
90026,San Diego Metropolitan Transit System,Full Reporter: Operating,Urban,30131982,2962362,34321429,1390960,0,0,68806733,3206694681,10640937,0,0,0,0,0,3217335618,3286142351,65198895,20750859,1845000,10622279,1173540,34391678,0,10603510,0,244858703,17545601,0,273007814,307399492,16464717,3027477037
90029,Omnitrans,Full Reporter: Operating,Urban,23697310,11816498,2833148,577377,0,0,38924333,142001106,0,0,0,19737432,103962852,0,265701390,304625723,20881681,5225726,0,1638963,5395797,12260486,0,8972487,0,36506036,0,65797437,111275960,123536446,4336218,197634740
90030,North County Transit District,Full Reporter: Operating,Urban,99728603,42777277,3287007,3061761,0,279806,149134454,635150139,7494868,17249869,10172257,135000747,0,0,805067880,954202334,13282236,33642246,1350000,4096676,29872838,68961760,17750000,0,5743024,47719172,2339890,34094436,107646522,176608282,17569361,773306927
90031,Riverside Transit Agency,Full Reporter: Operating,Urban,95157600,3384312,1270027,293371,0,0,100105310,75881319,0,0,0,0,0,11027190,86908509,187013819,21847361,6928731,0,8238922,70433423,85601076,0,0,0,8041332,0,0,8041332,93642408,7671233,107547539
90035,Gold Coast Transit District,Full Reporter: Operating,Urban,4634731,3851375,1117013,7201,0,0,9610320,62089979,0,0,0,0,5238926,221635,67550540,77160860,9692621,1343822,969967,1220336,111299,3645424,21005957,0,0,16961055,77231,1810073,39854316,43499740,1513795,41839946
90036,Orange County Transportation Authority,Full Reporter: Operating,Urban,673814322,67414062,5216843,21448943,0,261023,768155193,255042914,567966,12718,19779496,39571278,0,0,314974372,1083129565,44219885,64425250,7725453,7039199,21372984,100562886,0,0,242640,151620670,0,1123942,152987252,253550138,21808673,851990639
90045,Regional Transportation Commission of Southern Nevada,Full Reporter: Operating,Urban,55831726,147376184,0,198810,1088031657,0,1291438377,496669778,0,0,0,0,0,0,496669778,1788108155,44149907,98506107,60538211,19854245,298251,179196814,1229489083,0,0,71404881,17832397,0,1318726361,1497923175,14702901,319631986
90062,Monterey-Salinas Transit,Full Reporter: Operating,Urban,58082951,17132950,524346,729669,0,0,76469916,65548037,0,0,0,9414565,0,8725,74971327,151441243,9925123,6921517,362006,2355368,2462885,12101776,9554033,0,0,18658929,1466059,0,29679021,41780797,1395422,118190147
90078,Central Contra Costa Transit Authority,Full Reporter: Operating,Urban,20162412,22045335,979467,91274,0,0,43278488,28714316,0,0,0,18859147,0,0,47573463,90851951,10888758,17147699,0,3218738,20377124,40743561,0,0,0,0,0,18957282,18957282,59700843,1803901,40235965
90079,SunLine Transit Agency,Full Reporter: Operating,Urban,5745650,8019056,1478349,862989,0,2447789,18553833,84256479,0,0,0,1241783,0,0,85498262,104052095,16765374,1625904,0,1563518,9875875,13065297,2865681,0,0,0,0,0,2865681,15930978,9457501,95428990
90088,Napa Valley Transportation Authority,Full Reporter: Operating,Urban,3756315,6608865,197484,50329,912221,0,11525214,22461195,0,0,0,28402658,0,0,50863853,62389067,0,2078460,1000000,917435,3251252,7247147,0,0,0,0,0,18199700,18199700,25446847,0,36942220
90090,Yolo County Transportation District,Full Reporter: Operating,Urban,11792839,398343,0,0,0,4104735,16295917,19492523,0,0,0,0,1909114,191609,21593246,37889163,985108,3091243,0,58249,2651803,5801295,0,0,0,1510040,0,14390,1524430,7325725,236958,31311588
90121,Antelope Valley Transit Authority,Full Reporter: Operating,Urban,29284190,417736,351155,397759,0,0,30450840,105847807,0,0,0,3047390,0,0,108895197,139346037,1372075,3878787,0,900841,1282772,6062400,0,0,0,1878317,0,551815,2430132,8492532,6898,132218682
90134,Peninsula Corridor Joint Powers Board,Full Reporter: Operating,Urban,29484865,230176590,8291261,2386051,28508948,0,298847715,753024469,0,0,0,2775061638,0,0,3528086107,3826933822,977373,66509571,20964182,2274000,65600350,155348103,222771786,0,0,0,0,4491226,227263012,382611115,7031173,3438268907
90136,Regional Public Transportation Authority,Full Reporter: Operating,Urban,63100000,62317000,0,305000,225983000,0,351705000,106911000,0,14805000,0,21283000,14027000,1322000,158348000,510053000,7234000,196621000,21764000,3672000,447000,222504000,44687000,2782000,13501000,38005000,0,969000,99944000,322448000,3087000,191752000
90144,Livermore / Amador Valley Transit Authority,Full Reporter: Operating,Urban,26277704,10493063,0,637713,204032,87273,37699785,47034305,0,0,0,29777862,0,0,76812167,114511952,1584942,7173329,0,36344,87273,7296946,0,30199862,0,1658554,300685,471621,32630722,39927668,272705,75896521
90146,Foothill Transit,Full Reporter: Operating,Urban,30849914,42827622,0,2265069,0,0,75942605,225254938,0,0,0,0,115447804,1415716,342118458,418061063,0,12742066,0,0,31018586,43760652,0,0,0,0,0,108985046,108985046,152745698,1307200,264008165
90148,Victor Valley Transit Authority,Full Reporter: Operating,Urban,38647379,2355253,0,527015,0,0,41529647,85445320,0,0,0,0,0,143469,85588789,127118436,1350164,1900572,984754,3086280,10371174,16342780,28870068,0,0,0,143469,0,29013537,45356317,104082,83008201
90151,Southern California Regional Rail Authority,Full Reporter: Operating,Urban,77734667,109647416,16051278,465415,0,0,203898776,1364341973,0,0,0,0,62747392,12301054,1439390419,1643289195,15624085,46860839,0,41180745,109333953,197375537,0,10673632,13664661,20946474,0,11156000,56440767,253816304,4665622,1400431354
90154,Los Angeles County Metropolitan Transportation Authority ,Full Reporter: Operating/Building,Urban,8533942,305362536,75751752,11032164,77251553,8238723,486170670,12053368545,0,0,1173799216,8196281658,334507,17825865,21441609791,21927780461,513015297,359275164,290731793,601771277,270233534,1522011768,6080996432,0,0,1604499527,270715120,79700897,8035911976,9557923744,574303365,12308568649
90157,Access Services  ,Full Reporter: Operating,Urban,11439082,16417989,0,0,26256669,10676033,64789773,6223319,0,0,0,0,0,46903048,53126367,117916140,0,23925170,0,12198777,41971492,78095439,0,0,0,0,0,5123552,5123552,83218991,0,34697149
90159,Western Contra Costa Transit Authority,Full Reporter: Operating,Urban,5871648,2884670,0,148195,0,0,8904513,14881400,0,0,0,0,0,0,14881400,23785913,584389,315655,0,179587,8367047,8862289,0,0,0,894101,0,170653,1064754,9927043,46646,14396613
90162,The Eastern Contra Costa Transit Authority,Full Reporter: Operating,Urban,2472999,5022506,837998,1825,3086822,0,11422150,29637998,0,0,0,0,0,6148,29644146,41066296,0,5771623,106457,481194,3155709,9514983,913801,0,0,0,0,0,913801,10428784,0,30637512
90164,Ventura County Transportation Commission,Full Reporter: Operating,Urban,1153669,1480479,0,0,0,0,2634148,7661269,0,0,0,0,0,0,7661269,10295417,137988,2134878,0,128401,501726,2765005,0,0,0,0,0,0,0,2765005,34451,7633949
90173,Transit Joint Powers Authority for Merced County,Full Reporter: Operating,Urban,7950179,1063187,0,0,0,25993646,35007012,22077724,0,0,0,0,0,0,22077724,57084736,0,7423456,0,0,6128114,13551570,0,0,0,0,0,0,0,13551570,0,43533166
90182,Altamont Corridor Express,Full Reporter: Operating,Urban,43217334,31833835,7046657,5269764,0,0,87367590,283544634,0,0,2585984,0,0,0,286130618,373498208,0,5406058,2214120,22765217,0,30385395,36612185,0,0,0,0,201677,36813862,67199257,0,306298951
90200,Kings County Area Public Transit Agency,Full Reporter: Operating,Urban,6653425,3893107,0,244,0,0,10546776,13463130,0,0,1307881,2367227,0,0,17138238,27685014,243191,252511,441210,0,7372800,8066521,0,0,11968,0,0,0,11968,8078489,13906,19835810
90206,San Luis Obispo Regional Transit Authority,Full Reporter: Operating,Urban,4547840,210832,393136,5454809,0,2000,10608617,33263345,0,115762,0,0,0,184204,33563311,44171928,2899420,1848236,339861,224734,4288852,6701683,12311165,0,55884,4841422,0,362652,17571123,24272806,113453,22685089
90209,"Valley Metro Rail, Inc.",Full Reporter: Operating,Urban,15197443,268774865,26088989,3161052,0,8641,313230990,1465984623,0,3558674,976096,1050074721,0,0,2520594114,2833825104,0,71231640,0,18513324,1832981,91577945,0,111905491,13973233,0,976096,80521149,207375969,298953914,3548085,2531323105
90211,Anaheim Transportation Network,Full Reporter: Operating,Urban,3100684,3492387,56860,260385,0,2431069,9341385,38452408,0,0,0,0,0,0,38452408,47793793,0,4885424,334032,2341403,22011,7582870,10006443,0,0,0,0,0,10006443,17589313,0,30204480
90219,Northern Arizona Intergovernmental Public Transportation Authority,Full Reporter: Operating,Urban,5382872,4842809,369717,111697,0,0,10707095,24151775,0,0,0,4119794,0,0,28271569,38978664,1967392,1652286,0,730497,4200,2386983,0,0,0,6170766,0,6890282,13061048,15448031,2143642,23354383
90223,"Paratransit, Inc.",Full Reporter: Operating,Urban,1237752,3313523,114148,292290,0,0,4957713,5519110,0,0,225060,0,0,0,5744170,10701883,0,541500,371690,169545,0,1082735,2469928,0,0,0,0,0,2469928,3552663,0,7149220
90225,San Francisco Bay Area Water Emergency Transportation Authority,Full Reporter: Operating,Urban,17356307,19869959,93215,6215251,0,0,43534732,401266875,2728410,0,0,39239784,0,428313,443663382,487198114,1621885,7395136,0,130591,925035,8450762,0,6233001,0,0,0,0,6233001,14683763,973785,473162451
90226,Imperial County Transportation Commission,Full Reporter: Operating,Urban,26325557,915671,0,0,0,0,27241228,3621216,0,0,0,0,0,0,3621216,30862444,0,0,0,0,7079734,7079734,0,0,0,0,0,0,0,7079734,0,23782710
90230,California Vanpool Authority,Full Reporter: Operating,Urban,549551,1379744,0,545,0,0,1929840,1081886,144275,0,0,0,0,0,1226161,3156001,499744,1262138,96576,960464,0,2319178,643705,0,0,0,0,0,643705,2962883,403583,289279
90232,Solano County Transit,Full Reporter: Operating,Urban,1998282,8626690,460026,147800,4787289,0,16020087,43445060,313071,0,0,8009834,0,0,51767965,67788052,373429,2546965,0,284795,13687453,16519213,0,0,0,379900,0,231910,611810,17131023,0,51030458
90233,Yuma County Intergovernmental Public Transportation Authority,Full Reporter: Operating,Urban,85468,1251101,0,500,0,0,1337069,8092613,0,0,0,0,0,0,8092613,9429682,110921,1690698,0,0,45915,1736613,0,0,0,413996,0,0,413996,2150609,126632,7263362
90234,Marin County Transit District,Full Reporter: Operating,Urban,35886151,6777673,0,66648,0,0,42730472,46453670,0,0,0,2928305,0,0,49381975,92112447,105659,4969446,0,0,1582242,6551688,0,0,533532,155641,0,41291,730464,7282152,0,84935954
90299,Sonoma-Marin Area Rail Transit District,Full Reporter: Operating,Urban,23462791,22009006,2481651,2551592,93574429,0,144079469,491635167,82565,1630216,0,31562371,0,2189349,527099668,671179137,4804465,4967876,15265735,336378,1515542,22085531,77704597,0,1756409,4460300,0,367146,84288452,106373983,6123411,563486208
90306,Stanislaus Regional Transit Authority,Full Reporter: Operating,Urban,64238790,4998644,0,156212,0,0,69393646,27752381,0,0,0,0,0,0,27752381,97146027,0,5867261,79427,0,63931345,69878033,438911,0,334768,0,0,0,773679,70651712,0,26494315
90310,Tulare County Regional Transit Agency,Full Reporter: Operating,Urban,9237744,2722050,0,0,0,0,11959794,2382119,99217,0,0,0,0,0,2481336,14441130,0,3391437,0,21724,1602423,5015584,5000000,0,0,0,0,0,5000000,10015584,0,4425546
91092,Tahoe Transportation District,Full Reporter: Operating,Urban,3132277,910854,378679,321129,0,0,4742939,4150030,2439264,0,0,0,0,0,6589294,11332233,0,419416,0,24668,35936,480020,170280,0,0,0,0,0,170280,650300,0,10681933
99425,Pomona Valley Transportation Authority,Full Reporter: Operating,Urban,4507129,0,0,0,0,504824,5011953,504824,0,0,0,0,0,0,504824,5516777,0,0,0,0,0,0,0,0,0,0,478502,0,478502,478502,0,5038275
