NTD ID,Agency Name,Reporter Type,Reporting Module,CA: Cash and Cash Equivalents,CA: Accounts Receivable,CA: Inventory,CA: Prepaid Expenses,CA: Current Investments and Current Portions of Long-Term Investments,CA: Other Current Assets,Total Current Assets,NCA: Capital Assets,NCA: Intangible Assets,NCA: Capital Leases Receivables,NCA: Special Funds,NCA: Work in Progress,NCA: Investments,NCA: Other Noncurrent Assets,Total Noncurrent Assets,Total Assets,Deferred Outflows of Resources,CL: Current Accounts Payable,CL: Short-Term Debt and Current Portions of Long-Term Debt,CL: Accrued Liabilities,CL: Other Current Liabilities,Total Current Liabilities,NCL: Long-Term Debt,NCL: Noncurrent Accounts Payable,NCL: Capital Lease Obligations,NCL: Long-Term Pension Liabilities,NCL: Estimated Liabilities,NCL: Other Noncurrent Liabilities,Total Noncurrent Liabilities,Total Liabilities,Deferred Inflows of Resources,Net Position
2,Spokane Transit Authority,Full Reporter,Urban,135058458,31367420,1623863,256834,0,0,168306575,85601018,3013599,0,0,31162847,0,0,119777464,288084039,5837042,6886517,0,7023065,1630393,15539975,0,0,0,15122567,0,0,15122567,30662542,4011419,259247120
3,Pierce County Transportation Benefit Area Authority,Full Reporter,Urban,2292845,896144,4041153,759712,69198588,35968249,113156691,78464785,0,0,75694166,49013882,0,0,203172833,316329524,8132283,4933629,0,0,16776382,21710011,0,0,0,22913723,9285383,0,32199106,53909117,8678784,261873906
7,Lane Transit District,Full Reporter,Urban,25166563,23059118,1302337,621541,0,0,50149559,157836527,0,0,0,0,0,0,157836527,207986086,4665520,1678483,0,3710398,7637945,13026826,0,0,0,33693081,0,0,33693081,46719907,2538142,163393557
8,Tri-County Metropolitan Transportation District of Oregon,Full Reporter,Urban,181141148,86703878,52054283,10343048,0,103284134,433526491,2726924908,0,0,475462513,359952533,0,28892413,3591232367,4024758858,235293251,59728418,24256852,40806346,84462161,209253777,901260559,3571961,64189448,1099642403,20144574,0,2088808945,2298062722,110536551,1851452836
11,Valley Regional Transit,Full Reporter,Urban,2726868,2717531,477327,84789,0,0,6006515,28917731,0,0,0,263952,0,0,29181683,35188198,370603,2160389,0,827934,1371605,4359928,0,0,0,1171996,0,0,1171996,5531924,42151,29984726
18,Ben Franklin Transit,Full Reporter,Urban,38015727,27372896,390524,375862,0,0,66155009,34652948,532996,0,0,1947328,0,0,37133272,103288281,2516087,1506958,0,1854577,0,3361535,0,0,0,6471330,0,6096577,12567907,15929442,1814997,88059929
19,Intercity Transit,Full Reporter,Urban,119321018,32095590,1028400,350240,0,0,152795248,61192822,0,0,0,14713684,0,0,75906506,228701754,7016993,4270458,0,1375531,283882,5929871,0,0,0,20309323,0,2932784,23242107,29171978,3259372,203287397
20,Kitsap Transit,Full Reporter,Urban,10512447,26334236,1774177,927706,58110668,0,97659234,114288664,335756,0,531758,48142717,0,141862,163440757,261099991,3278196,4959348,3903558,3842799,0,12705705,35908111,0,0,7782165,0,0,43690276,56395981,2477131,205505075
21,Whatcom Transportation Authority,Full Reporter,Urban,35001538,7120809,1241127,300721,0,0,43664195,37349355,0,0,0,3204289,0,0,40553644,84217839,2266437,1618698,0,3180824,8333,4807855,0,0,0,6350706,0,197793,6548499,11356354,1760354,73367568
24,Clark County Public Transportation Benefit Area Authority,Full Reporter,Urban,9041512,14746411,2200632,1458644,0,0,27447199,119643535,6508970,0,95089064,6513559,0,134308,227889436,255336635,3964025,1926684,0,5584916,219319,7730919,0,0,0,10012130,598445,643484,11254059,18984978,3159986,237155696
25,Salem Area Mass Transit District,Full Reporter,Urban,2832277,12802843,922508,447199,0,6630,17011457,41823075,0,0,0,6488767,15477445,0,63789287,80800744,4949950,1590391,0,3013358,139665,4743414,0,0,0,10562873,0,0,10562873,15306287,1877521,68566886
29,Snohomish County Public Transportation Benefit Area Corporation,Full Reporter,Urban,210472548,44694455,1630721,147403,0,0,256945127,234478094,3427582,0,1553000,27712783,99779459,0,366950918,623896045,11862601,8592864,1267732,9043168,4265155,23168919,8008230,0,0,36306431,3236365,0,47551026,70719945,6216023,558822678
34,Rogue Valley Transportation District,Full Reporter,Urban,7376167,10485699,474597,69837,0,0,18406300,19931273,0,0,0,0,0,0,19931273,38337573,0,1281847,0,643377,0,1925224,329904,0,0,0,0,0,329904,2255128,0,0
40,Central Puget Sound Regional Transit Authority,Full Reporter,Urban,288296647,426022803,24089167,14487044,867750946,4324630,1624971237,5360261302,864155043,341211659,250548659,7759727288,668168488,21098282,15265170721,16890141958,29654516,342252633,54300000,61082704,13283640,470918977,2377960042,0,175733043,0,0,13660899,2567353984,3038272961,18429178,13863094335
43,Chelan Douglas PTBA ,Full Reporter,Urban,3395533,4524270,343943,23665,15064956,0,23352367,33181316,0,0,66370,71571,0,0,33319257,56671624,1114495,4710114,0,872899,0,5583013,0,0,0,2731649,0,50000,2781649,8364662,847891,48573566
44,Skagit Transit,Full Reporter,Urban,15283714,3417452,474548,0,0,0,19175714,27084809,162473,0,0,2088136,0,0,29335418,48511132,0,75697,0,610971,3327,689995,0,0,0,0,0,342389,342389,1032384,0,0
10001,Rhode Island Public Transit Authority,Full Reporter,Urban,9732830,10339790,2003631,1905782,1034903,0,25016936,111529642,0,0,3063537,19930322,4978190,0,139501691,164518627,22733960,15937311,2889961,10090904,297620,29215796,9012000,0,0,143000107,14302902,0,166315009,195530805,8333715,-16611933
10003,Massachusetts Bay Transportation Authority,Full Reporter,Urban,215979205,173694073,62207787,2036934,34659061,273479478,762056538,11076492159,0,29100285,0,0,0,826086397,11931678841,12693735379,558376044,399137966,338161677,278915361,0,1016215004,5172268143,0,78379032,3846348010,0,168918080,9265913265,10282128269,399730035,2570253119
10004,Brockton Area Transit Authority,Full Reporter,Urban,2285980,5090816,0,0,0,178057,7554853,20566608,0,0,0,0,0,1371137,21937745,29492598,329075,543667,0,212635,1123646,1879948,6300000,0,0,911188,0,1053111,8264299,10144247,61845,19615581
10005,Lowell Regional Transit Authority,Full Reporter,Urban,518675,3405661,0,52376,0,574265,4550977,36317898,0,0,0,0,0,2410503,38728401,43279378,0,682296,5600000,104832,0,6387128,0,0,0,1226960,0,113153,1340113,7727241,71523,0
10006,Southeastern Regional Transit Authority,Full Reporter,Urban,1203864,11142013,995298,137976,0,0,13479151,20742867,0,0,0,1735799,0,0,22478666,35957817,1911004,4213911,4756198,205453,0,9175562,0,0,0,7392330,741627,0,8133957,17309519,1589976,18969326
10007,Berkshire Regional Transit Authority,Full Reporter,Urban,1928815,4110268,0,20724,0,773741,6833548,12525206,0,0,0,0,0,0,12525206,19358754,127444,363115,5150000,120916,188065,5822096,0,0,0,768670,0,0,768670,6590766,0,0
10008,Pioneer Valley Transit Authority,Full Reporter,Urban,1687360,17776116,0,538274,3982536,0,23984286,110958935,0,0,3636854,0,0,0,114595789,138580075,2163931,5264864,13000000,119239,3197777,21581880,0,0,0,36090785,0,0,36090785,57672665,12310495,70760846
10013,Merrimack Valley Regional Transit Authority,Full Reporter,Urban,2946748,6803264,0,134634,0,0,9884646,57854000,0,0,267028,0,0,444583,58565611,68450257,388895,673654,8734634,48641,0,9456929,444583,0,0,857315,0,106372,1408270,10865199,0,0
10014,Worcester Regional Transit Authority,Full Reporter,Urban,2254101,9877079,374271,17494,0,0,12522945,104562471,200285,0,0,0,0,0,104762756,117285701,2320664,1848363,12900000,164922,57263,14970548,0,0,0,13178671,9252389,0,22431060,37401608,453623,81751134
10016,Greater Portland Transit District,Full Reporter,Urban,2078029,933725,320379,71297,0,0,3403430,15629625,0,0,0,117276,0,0,15746901,19150331,108364,673094,182500,277296,0,1132890,1425500,0,0,642935,5000,102094,2175529,3308419,67150,15883126
10017,Greater Hartford Transit District,Full Reporter,Urban,326969,1603229,0,131690,1264744,0,3326632,35765110,0,0,0,0,5058977,0,40824087,44150719,0,4284713,0,543174,480061,5307948,0,0,0,767207,0,0,767207,6075155,0,0
10040,Southeast Area Transit District,Full Reporter,Urban,193596,734602,263531,123288,0,0,1315017,10735171,0,0,0,0,0,0,10735171,12050188,0,228917,440219,133278,0,802414,0,0,0,0,0,0,0,802414,0,0
10042,Valley Transit District,Full Reporter,Urban,56767,742683,13070,9821,0,23992,846333,5122313,0,0,0,0,0,0,5122313,5968646,0,41621,0,50743,18799,111163,81719,0,0,0,0,0,81719,192882,0,0
10049,Greater New Haven Transit District,Full Reporter,Urban,1313060,758226,55372,38876,0,0,2165534,7700210,0,0,0,0,0,0,7700210,9865744,0,452878,0,403360,95174,951412,0,0,0,0,0,0,0,951412,0,0
10050,Greater Bridgeport Transit Authority,Full Reporter,Urban,2452934,5066942,996117,190223,0,0,8706216,35724619,0,0,0,98525,0,0,35823144,44529360,514274,2781808,0,4803868,177440,7763116,0,0,0,12966459,244265,0,13210724,20973840,1157000,22912794
10051,Housatonic Area Regional Transit ,Full Reporter,Urban,968659,1100637,71885,49597,0,0,2190778,33087349,0,0,0,0,1840266,0,34927615,37118393,0,224007,267038,100772,0,591817,64867,0,0,0,0,0,64867,656684,0,0
10053,Cape Ann Transportation Authority,Full Reporter,Urban,505467,1706149,0,21766,0,640957,2874339,6521843,0,0,0,0,0,0,6521843,9396182,0,451564,0,104992,0,556556,2300000,0,0,0,0,0,2300000,2856556,0,0
10057,Norwalk Transit District,Full Reporter,Urban,99386,1648812,437740,104973,0,0,2290911,25740569,0,0,0,881068,0,0,26621637,28912548,0,171026,2660409,1468344,0,4299779,0,0,0,0,166543,0,166543,4466322,0,0
10061,Montachusett Regional Transit Authority,Full Reporter,Urban,3411660,11452549,0,0,0,918074,15782283,46744637,0,0,0,0,0,0,46744637,62526920,0,6110611,19803333,541549,450547,26906040,263337,0,0,0,0,0,263337,27169377,0,0
10064,Greater Attleboro-Taunton Regional Transit Authority,Full Reporter,Urban,1912938,9844312,303955,0,0,0,12061205,22188667,0,0,0,0,0,4454647,26643314,38704519,1565100,2516057,8200000,185827,214720,11116604,0,0,0,6220265,0,279558,6499823,17616427,1878641,20774551
10066,Green Mountain Transit Authority,Full Reporter,Urban,1730195,3785999,653038,395428,0,0,6564660,61042669,0,0,0,1175405,0,0,62218074,68782734,392276,1603022,0,1313685,21545,2938252,0,0,0,0,0,0,0,2938252,0,0
10086,Cooperative Alliance for Seacoast Transportation,Full Reporter,Urban,1046976,518584,81262,37397,0,0,1684219,3177789,0,0,0,0,0,0,3177789,4862008,0,66684,0,382058,44479,493221,0,0,0,0,0,0,0,493221,0,0
10088,Casco Bay Island Transit District,Full Reporter,Urban,4334733,695143,89152,44638,0,0,5163666,6468589,0,0,1685380,1190141,0,0,9344110,14507776,0,177089,0,639659,1529,818277,0,0,0,0,0,1634228,1634228,2452505,0,0
10098,"Western Maine Transportation Services, Inc.",Full Reporter,Urban,194834,619324,277154,194979,0,0,1286291,2551345,0,0,0,0,0,0,2551345,3837636,0,59459,386152,191801,0,637412,1349964,0,0,0,0,0,1349964,1987376,0,0
10105,Cape Cod Regional Transit Authority,Full Reporter,Urban,506078,4588951,0,0,0,957263,6052292,29046335,156605,0,0,0,0,2988808,32191748,38244040,806258,729891,101535,380334,0,1211760,7500000,938110,0,2296232,0,1725139,12459481,13671241,382013,24997044
10107,Milford Transit District,Full Reporter,Urban,89626,310274,0,0,0,0,399900,4402030,0,0,0,0,0,0,4402030,4801930,0,156426,0,55171,0,211597,4192030,0,0,0,0,159333,4351363,4562960,65000,0
10115,Northern New England Passenger Rail Authority,Full Reporter,Urban,2092771,2799082,65225,98670,0,0,5055748,14346412,0,0,0,514480,0,455658,15316550,20372298,514480,2694419,0,44594,0,2739013,0,0,0,1608675,0,0,1608675,4347688,176845,16362245
10118,MetroWest Regional Transit Authority,Full Reporter,Urban,1597843,9587766,0,539817,0,0,11725426,20120046,0,0,124968,0,0,0,20245014,31970440,843000,482336,800000,249782,0,1532118,0,528879,0,3028000,0,9789397,13346276,14878394,0,0
10128,Connecticut Department of Transportation- CTTransit Waterbury- NET,Full Reporter,Urban,696242,1859653,1024405,204579,0,0,3784879,0,0,0,0,0,0,374800,374800,4159679,0,113242,1064772,964563,0,2142577,0,0,0,0,189359,769708,959067,3101644,0,0
10183,"Woods Hole, Martha's Vineyard and Nantucket Steamship Authority",Full Reporter,Urban,9993525,2102097,610997,3991186,2699094,0,19396899,206624385,0,0,32161486,7046666,0,239862,246072399,265469298,7561781,4910166,9013346,4333199,7776501,26033212,82722609,0,0,33546746,0,0,116269355,142302567,1262408,129466104
20002,Capital District Transportation Authority,Full Reporter,Urban,3339447,33528052,0,0,0,4262794,41130293,119752343,0,0,17584279,0,0,0,137336622,178466915,19999662,12544775,0,0,3757992,16302767,0,0,3132032,105346823,10550690,1616083,120645628,136948395,11745223,49772959
20004,Niagara Frontier Transportation Authority,Full Reporter,Urban,16297000,60820000,5665000,155000,0,0,82937000,301470000,0,0,2446000,0,0,0,303916000,386853000,22276000,18831000,3754000,0,927000,23512000,11946000,0,0,458173000,40093000,1988000,512200000,535712000,1291000,-127874000
20008,MTA New York City Transit,Full Reporter,Urban,228126558,590545312,305000044,40035043,0,0,1163706957,41642476838,0,0,593815,4491664174,0,0,46134734827,47298441784,2690580886,487858615,808754405,1261251669,255035347,2812900036,59249093,0,181950863,20221773786,3153343712,323239126,23939556580,26752456616,1412717647,21823848407
20018,Central New York Regional Transportation Authority,Full Reporter,Urban,7628568,5974136,4043134,5420115,0,0,23065953,93000948,0,0,0,280219,0,24337874,117619041,140684994,125717837,2431478,0,2961524,987397,6380399,0,0,0,416044501,3185021,27959702,447189224,453569623,2573609,-189740401
20075,Port Authority Transit Corporation,Full Reporter,Urban,1032316,3036585,6400229,1348577,2805563,0,14623270,0,0,0,142500,0,0,0,142500,14765770,11678294,2709072,0,1621321,10075265,14405658,0,0,0,19972997,13395391,287584000,320952388,335358046,2462978,-311376960
20078,"Metro-North Commuter Railroad Company, dba: MTA Metro-North Railroad",Full Reporter,Urban,22823746,116365435,168144812,24568300,89885861,10525775,432313929,4066700733,0,0,0,1761454622,0,0,5828155355,6260469284,591399997,71272168,0,415486812,31702593,518461573,0,0,0,2241582113,50143518,69702538,2361428169,2879889742,204219586,3767759953
20080,New Jersey Transit Corporation,Full Reporter,Urban,183171780,42177642,150293562,0,20055667,256632662,652331313,4383695195,0,0,835221519,1834758208,0,2839584,7056514506,7708845819,568657978,192605576,139185427,107795379,83178178,522764560,1161136638,0,199790214,753054330,1920137032,73227095,4107345309,4630109869,131318532,3516075396
20098,Port Authority Trans-Hudson Corporation,Full Reporter,Urban,393568543,890255134,49401296,143772508,929604174,49866671,2456468326,38972887465,0,0,0,800660696,2275702926,3838968044,45888219131,48344687457,775555781,1057116044,1132079348,784104080,745367,2974044839,25683240824,1244413236,0,2020090050,0,1055012112,30002756222,32976801061,578037649,15565404528
20099,Staten Island Rapid Transit Operating Authority,Full Reporter,Urban,154170,43015894,1860668,880648,0,0,45911380,247830020,0,0,0,327239127,0,0,575069147,620980527,42774793,2134292,0,12171640,21008449,35314381,0,0,0,104442730,19911011,538017,124891758,160206139,23150832,480398349
20100,MTA Long Island Rail Road,Full Reporter,Urban,5389785,291276507,161478270,31601508,0,0,489746070,5988209994,0,0,0,2855690983,0,0,8843900977,9333647047,691843187,184473697,3403233,262904412,9393786,460175128,23410364,0,0,3596673134,152807929,100672962,3873564389,4333739517,462108409,5229642308
20113,Regional Transit Service - Monroe County,Full Reporter,Urban,12806734,6563931,441446,831325,16416692,0,37060128,129925067,0,0,0,0,14552314,0,144477381,181537509,34305903,5045042,0,4569563,9905817,19520422,0,0,0,15775076,146035991,641445,162452512,181972934,8853311,25017167
20188,MTA Bus Company,Full Reporter,Urban,473245,124236259,14447829,5887433,0,69167588,214212354,364213618,0,0,0,0,0,372843854,737057472,951269826,0,8475657,61081286,85756053,86606829,241919825,0,0,0,402346445,1258638858,0,1660985303,1902905128,0,0
30001,Kanawha Valley Regional Transportation Authority,Full Reporter,Urban,11721039,1263002,425393,0,0,160171,13569605,12939164,0,0,0,0,534640,0,13473804,27043409,1568526,25000,0,692019,0,717019,0,0,0,9953714,0,0,9953714,10670733,2076002,15865200
30002,The Tri-State Transit Authority,Full Reporter,Urban,9461816,596803,290222,28452,0,0,10377293,31351309,0,0,0,0,0,0,31351309,41728602,347986,76875,0,1156890,0,1233765,0,0,0,0,0,0,0,1233765,924555,39918268
30006,Greater Richmond Transit Company,Full Reporter,Urban,16185237,9650118,873649,1137001,0,0,27846005,81532901,1386298,0,0,0,0,0,82919199,110765204,9789698,7848685,0,96144,205721,8150550,0,0,0,46539149,363272,3623065,50525486,58676036,8702298,53176568
30007,Greater Roanoke Transit Company,Full Reporter,Urban,1212645,3515460,496106,3602,0,0,5227813,14434645,0,0,0,0,0,0,14434645,19662458,0,2110415,0,446461,1982037,4538913,0,0,0,0,0,0,0,4538913,0,0
30008,Greater Lynchburg Transit Company,Full Reporter,Urban,584389,727020,293416,198155,0,0,1802980,34133648,0,0,0,0,0,0,34133648,35936628,64588,608524,0,190067,73045,871636,0,96935,0,0,0,648234,745169,1616805,750,34383661
30010,Lehigh and Northampton Transportation Authority,Full Reporter,Urban,8370089,4849070,566063,14677399,0,0,28462621,42561497,0,0,0,0,0,0,42561497,71024118,1992421,2305033,1773060,1983315,8696937,14758345,0,0,0,14847688,0,14498901,29346589,44104934,789660,28121945
30011,Altoona Metro Transit,Full Reporter,Urban,909932,1066669,228014,109143,4064613,0,6378371,13214044,0,0,0,0,0,0,13214044,19592415,296671,289408,0,0,473296,762704,0,0,0,698929,0,5242983,5941912,6704616,147049,13037421
30012,Cambria County Transit Authority,Full Reporter,Urban,7050460,916755,481266,189678,0,0,8638159,35400632,0,0,0,0,0,0,35400632,44038791,822510,180668,0,442836,0,623504,0,0,0,1942439,0,7492234,9434673,10058177,118154,34684970
30013,Erie Metropolitan Transit Authority,Full Reporter,Urban,9130597,991876,173709,368706,0,0,10664888,78351663,0,0,0,0,0,0,78351663,89016551,2913447,1590815,0,1657862,6028532,9277209,0,0,0,3081262,0,5683835,8765097,18042306,1098540,72789152
30014,Cumberland Dauphin-Harrisburg Transit Authority,Full Reporter,Urban,3324342,2917825,386243,289261,0,0,6917671,23731645,0,0,0,0,0,75915,23807560,30725231,2387325,773425,0,908781,4867606,6549812,0,0,0,0,500267,307922,808189,7358001,1279302,24475253
30015,Luzerne County Transportation Authority,Full Reporter,Urban,2668425,3827739,477665,322918,0,0,7296747,12435659,0,0,0,0,0,0,12435659,19732406,154239,209033,0,474638,12729334,13413005,0,0,0,636941,0,0,636941,14049946,667684,5169015
30019,Southeastern Pennsylvania Transportation Authority,Full Reporter,Urban,50370824,173580780,100656174,23591689,18258456,211901545,578359468,4239920782,0,0,43269896,482939028,0,3513002,4769642708,5348002176,254534724,114347371,33873877,221076660,287181921,656479829,504506854,0,27724002,895199565,124625083,1260969720,2813025224,3469505053,557340340,1575691507
30022,Port Authority of Allegheny County,Full Reporter,Urban,103737815,75558674,18183992,863259,0,0,198343740,1251124999,0,0,0,0,0,51518704,1302643703,1500987443,158778888,13490327,13830000,26587064,171063252,224970643,145088349,0,0,358065922,0,675811595,1178965866,1403936509,96742274,159087548
30023,Beaver County Transit Authority,Full Reporter,Urban,3018638,2319016,245796,184250,0,0,5767700,22410373,0,0,0,480390,0,0,22890763,28658463,0,653011,0,337745,0,990756,0,0,0,0,12563,0,12563,1003319,3507731,0
30025,County of Lackawanna Transit System,Full Reporter,Urban,3596892,162210,299640,312249,304748,2965704,7641443,24800877,0,0,0,0,0,0,24800877,32442320,219304,238025,0,1451488,7241485,8930998,175000,0,0,2544281,0,704989,3424270,12355268,0,0
30027,Central Pennsylvania Transportation Authority,Full Reporter,Urban,6314356,8528967,375674,497136,0,0,15716133,44825449,0,0,0,673247,0,0,45498696,61214829,0,700396,0,1146485,12007228,13854109,0,0,0,0,0,0,0,13854109,0,47360720
30030,Washington Metropolitan Area Transit Authority,Full Reporter,Urban,743774122,228004835,137385809,0,2676349,0,1111841115,13004790898,0,0,0,0,0,0,13004790898,14116632013,715426048,315670043,26000000,494029878,62994861,898694782,1729183437,19529639,0,3305313145,136388333,23451460,5213866014,6112560796,356158068,8363339197
30035,Ohio Valley Regional Transportation Authority,Full Reporter,Urban,3362419,1717705,72277,71675,714050,20205,5958331,3357732,0,0,702484,0,0,0,4060216,10018547,275092,129600,0,711584,73182,914366,0,0,90509,497168,0,0,587677,1502043,332544,8459052
30045,"JAUNT, Inc.",Full Reporter,Urban,2201422,1265290,0,237241,0,0,3703953,6687299,0,0,0,1215318,0,0,7902617,11606570,0,0,0,0,685112,685112,0,0,0,0,0,0,0,685112,0,0
30054,Centre Area Transportation Authority,Full Reporter,Urban,3250833,10164106,405211,306494,0,0,14126644,58679974,0,0,0,0,0,0,58679974,72806618,0,561881,2500000,1414233,9683314,14159428,0,0,0,0,0,0,0,14159428,0,0
30061,Mid Mon Valley Transit Authority,Full Reporter,Urban,689386,3331630,2500,0,0,0,4023516,13654720,12648,0,0,0,0,0,13667368,17690884,0,0,0,0,3824098,3824098,0,0,0,0,0,0,0,3824098,0,0
30070,Potomac and Rappahannock Transportation Commission,Full Reporter,Urban,19224284,26805468,0,303253,0,15728773,62061778,88155088,0,0,0,0,0,0,88155088,150216866,564254,5417113,260000,655632,13079990,19412735,656113,0,0,450137,0,528564,1634814,21047549,124337,129609234
30073,Virginia Railway Express,Full Reporter,Urban,97142781,22055686,2751678,127880,0,11124,122089149,335019850,0,0,14862978,0,0,787618,350670446,472759595,393423,3613496,3906946,1570488,1818911,10909841,44846530,0,6984969,669420,15706,736544,53253169,64163010,174555,408815453
30075,Delaware Transit Corporation,Full Reporter,Urban,15618857,23423726,4562636,57171,0,0,43662390,142573174,0,0,13292,7881517,4371318,0,154839301,198501691,25021459,5549117,0,6672799,0,12221916,0,2713030,0,187671085,0,7595966,197980081,210201997,40822999,-27501846
30076,Williamsburg Area Transit Authority,Full Reporter,Urban,1933934,1026629,0,0,0,0,2960563,8096080,0,0,0,160226,0,242599,8498905,11459468,0,258727,0,0,356315,615042,0,0,0,0,0,0,0,615042,16192,0
30083,Transportation District Commission of Hampton Roads,Full Reporter,Urban,10725706,60964182,9314677,1804798,408544,0,83217907,246736150,51322,0,0,6290392,1000,0,253078864,336296771,7215788,20287510,5183687,3550067,35672288,64693552,0,0,473615,10971281,0,3822548,15267444,79960996,1912256,261639307
30095,County of Lebanon Transit Authority,Full Reporter,Urban,3192154,341199,100025,108385,0,0,3741763,6935175,0,0,0,0,0,0,6935175,10676938,0,82553,0,114427,3576506,3773486,0,0,0,0,0,0,0,3773486,0,0
30096,The Tri-County Council for the Lower Eastern Shore of Maryland,Full Reporter,Urban,967600,0,0,0,0,0,967600,18254965,0,0,0,0,0,0,18254965,19222565,0,0,0,0,72361,72361,0,0,0,0,0,0,0,72361,0,0
30111,Washington County Transportation Authority,Full Reporter,Urban,1630624,763014,0,15984,0,106,2409728,7297562,0,0,0,0,0,0,7297562,9707290,0,473486,0,16791,0,490277,0,0,0,0,0,1504489,1504489,1994766,0,0
30137,Monroe County Transportation  Authority,Full Reporter,Urban,1775953,362761,121186,12150,0,0,2272050,9087741,0,0,0,0,0,0,9087741,11359791,0,1494371,0,0,0,1494371,0,0,0,0,0,0,0,1494371,0,0
30202,South Central Transit Authority,Full Reporter,Urban,24015999,3844406,903227,144716,0,3237373,32145721,95498778,0,0,0,0,0,350483,95849261,127994982,1624076,1221290,0,1305513,25597164,28123967,0,0,0,4711615,0,0,4711615,32835582,1120023,95663453
40004,Metropolitan Transit Authority,Full Reporter,Urban,5396168,7995722,2675559,1031960,0,0,17099409,141821359,0,0,534789,22625060,350000,0,165331208,182430617,25848956,2770459,5500000,7305284,863198,16438941,0,0,0,104410358,0,7809116,112219474,128658415,3915737,75705421
40006,Cape Fear Public Transportation Authority,Full Reporter,Urban,242607,607467,174467,128844,0,0,1153385,30119440,0,0,0,37457,0,0,30156897,31310282,252625,143103,0,654574,0,797677,0,0,0,417287,0,0,417287,1214964,7472,30340471
40012,City of Winston Salem,Full Reporter,Urban,1111437,6340867,311875,0,0,0,7764179,25153709,0,0,0,0,0,0,25153709,32917888,0,1117625,0,0,113661,1231286,0,0,0,0,0,0,0,1231286,0,0
40014,Ms Coast Transportation Authority,Full Reporter,Urban,1639148,863565,2201832,66448,0,0,4770993,20437711,0,0,0,11601652,0,0,32039363,36810356,0,436938,0,451863,0,888801,0,0,0,0,0,0,0,888801,0,0
40017,Lexington Transit Authority,Full Reporter,Urban,15405106,13868100,685762,27460,0,0,29986428,25842330,0,0,0,423204,0,0,26265534,56251962,2285415,645506,0,690557,0,1336063,4904677,0,0,0,0,0,4904677,6240740,2589356,49707281
40018,Transit Authority of River City,Full Reporter,Urban,8489397,8985243,1521273,1335125,0,0,20331038,77318967,0,0,0,0,31000,0,77349967,97681005,27776190,5949603,5447244,5856112,2052705,19305664,262538,0,0,94071317,1682198,22204681,118220734,137526398,9851103,-21920306
40019,Transit Authority of Northern Kentucky,Full Reporter,Urban,1627624,43287,881898,82419,4633370,29139,7297737,35007041,0,0,0,0,313000,0,35320041,42617778,1720560,1180663,0,288804,70411,1539878,0,77544,0,14235222,166000,5431461,19910227,21450105,3826625,19061608
40022,Metropolitan Atlanta Rapid Transit Authority,Full Reporter,Urban,46944808,225656994,33865845,10371506,492479327,161932083,971250563,2706717131,0,0,0,350409865,360433307,37901307,3455461610,4426712173,132395089,119468905,0,24394870,139749599,283613374,2389769002,0,346625398,97369429,0,166112825,2999876654,3283490028,135120097,1140497137
40025,Chatham Area Transit Authority,Full Reporter,Urban,3201556,12135199,416558,211122,15559,0,15979994,45498920,0,0,0,0,0,0,45498920,61478914,101176,548461,1500000,1226907,329766,3605134,0,0,0,897568,0,155000,1052568,4657702,124735,56797653
40027,Pinellas Suncoast Transit Authority,Full Reporter,Urban,44325509,12366210,2898621,332848,0,0,59923188,85762071,0,0,0,0,0,0,85762071,145685259,11959718,2336995,0,2331338,3782064,8450397,0,0,0,35250181,2452283,5529211,43231675,51682072,3233842,102729063
40031,Lakeland Area Mass Transit District ,Full Reporter,Urban,1395970,1818705,206245,375,4887240,0,8308535,13089441,0,0,0,0,1529736,0,14619177,22927712,3709835,690107,266924,54363,79833,1091227,0,0,1227751,8409783,0,469112,10106646,11197873,290097,15149577
40035,Central Florida Regional Transportation Authority,Full Reporter,Urban,62916827,32134397,2497868,0,0,2268635,99817727,131610202,0,0,0,11290743,7695257,0,150596202,250413929,8308487,12733247,10305980,2049999,13361054,38450280,0,0,0,8417778,7313068,0,15730846,54181126,1227139,203314151
40040,Jacksonville Transportation Authority,Full Reporter,Urban,16746469,160946100,2929529,692668,0,12781055,194095821,150911910,0,0,2359198,124292412,1995659,3853318,283412497,477508318,8930302,4764620,0,6956115,2134140,13854875,0,232457744,0,188079358,361936,0,420899038,434753913,3261846,48422861
40041,Hillsborough Area Regional Transit Authority,Full Reporter,Urban,200251849,23439650,1939187,508821,0,0,226139507,104085409,0,0,0,6221020,0,0,110306429,336445936,16063147,4510817,168757,1617934,3699661,9997169,0,0,0,54526127,5920478,0,60446605,70443774,2359866,279705443
40042,Birmingham-Jefferson County Transit Authority,Full Reporter,Urban,10225589,272365,1230932,208719,0,0,11937605,44406640,0,0,0,776483,0,9950,45193073,57130678,3642837,1163835,0,503660,722018,2389513,0,0,0,28395297,0,0,28395297,30784810,1710164,28278541
40053,Greenville Transit Authority,Full Reporter,Urban,4399364,803899,279790,108294,0,0,5591347,9621343,0,0,0,280652,0,0,9901995,15493342,0,859684,0,0,15510,875194,0,0,0,0,0,0,0,875194,0,0
40057,Jackson Transit Authority,Full Reporter,Urban,677309,1157377,113340,82113,0,0,2030139,6783053,0,0,0,0,0,0,6783053,8813192,427942,53064,0,260566,0,313630,0,0,0,1355222,0,0,1355222,1668852,204187,7368095
40077,South Florida Regional Transportation Authority,Full Reporter,Urban,65056131,37909654,0,1483451,0,0,104449236,605588796,0,0,0,0,0,0,605588796,710038032,3325994,12923418,0,5924183,7128667,25976268,33387566,0,0,11403304,0,10379457,55170327,81146595,1071947,631145484
40086,Metropolitan Bus Authority,Full Reporter,Urban,1357833,279249,6058901,0,0,0,7695983,19306887,0,0,0,121599,0,0,19428486,27124469,54990097,117610124,868333,26825387,0,145303844,329566983,0,0,4857884,0,2089876,336514743,481818587,26250200,-425954221
40100,Santee Wateree Regional Transportation Authority,Full Reporter,Urban,386289,207679,0,41827,0,0,635795,13226495,0,0,57088,0,0,0,13283583,13919378,445736,89716,0,0,0,89716,335412,0,0,0,0,0,335412,425128,674809,13265177
40108,Research Triangle Regional Public Transportation Authority,Full Reporter,Urban,79988242,38583774,1264759,1223469,287539890,0,408600134,59308113,0,0,0,0,0,24701926,84010039,492610173,0,7507047,616592,0,0,8123639,4612004,0,0,0,0,0,4612004,12735643,615031,0
40110,Charleston Area Regional Transportation Authority,Full Reporter,Urban,4428509,4981596,24657,293127,0,0,9727889,26030576,0,0,0,0,0,0,26030576,35758465,0,1761277,0,39350,186661,1987288,1789072,0,0,230657,0,0,2019729,4007017,0,0
40141,Central Midlands Regional Transportation Authority,Full Reporter,Urban,10509185,13078589,123453,34922,13605,0,23759754,23986204,0,0,0,0,19868142,0,43854346,67614100,441553,3288118,0,48727,34733,3371578,0,0,0,1909920,0,22822,1932742,5304320,60678,62690655
40159,Regional Transportation Authority,Full Reporter,Urban,5174088,1839445,407321,86876,0,0,7507730,37252733,0,0,0,0,0,0,37252733,44760463,0,2072996,0,26800,1643847,3743643,0,0,0,0,0,0,0,3743643,0,0
40172,Western Piedmont Regional Transit Authority ,Full Reporter,Urban,2302385,2607596,0,1000,0,1291,4912272,1638219,0,0,0,0,0,0,1638219,6550491,540534,112687,0,203279,0,315966,0,0,0,853686,0,0,853686,1169652,1296,5920077
40173,Piedmont Authority for Regional Transportation,Full Reporter,Urban,10083544,2105028,0,0,0,0,12188572,24482919,0,0,0,0,0,0,24482919,36671491,0,637262,0,9178,169476,815916,0,0,0,0,0,29036,29036,844952,167597,35658942
40191,Transit Authority of Central Kentucky,Full Reporter,Urban,660691,285770,0,0,0,23116,969577,2555659,0,0,0,0,0,0,2555659,3525236,0,15639,0,84272,111496,211407,0,0,0,0,0,3321608,3321608,3533015,0,0
40200,Tampa Bay Area Regional Transit Authority,Full Reporter,Urban,112836,2132528,0,0,0,0,2245364,21954,0,0,0,0,0,7318,29272,2274636,0,1599589,0,52875,209258,1861722,0,0,0,0,0,238103,238103,2099825,0,0
40950,First Tennessee Human Resource Agency,Full Reporter,Urban,4335581,1555418,0,102297,0,0,5993296,1258056,0,0,0,0,0,0,1258056,7251352,0,5523,0,0,0,5523,0,0,0,0,0,0,0,5523,0,0
50010,METRO Regional Transit Authority ,Full Reporter,Urban,71319421,29672681,1578997,3635481,0,0,106206580,158725112,0,0,0,1311148,0,0,160036260,266242840,5548271,5516682,0,3026555,46014,8589251,0,0,0,34152127,133672,0,34285799,42875050,7588784,221327277
50011,Stark Area Regional Transit Authority,Full Reporter,Urban,7744401,62975,428874,964049,7097298,3808683,20106280,35559757,47853,0,0,14731049,0,92230,50430889,70537169,4423106,909406,0,1382747,1311000,3603153,0,0,0,23105340,0,0,23105340,26708493,4289306,43962476
50012,Southwest Ohio Regional Transit Authority,Full Reporter,Urban,14078,40883378,1518881,890173,26452766,0,69759276,98523481,0,0,0,2599387,11388473,734660,113246001,183005277,18759887,4154738,0,8841980,1099136,14095854,0,7356806,0,115326766,0,1071278,123754850,137850704,22359564,41554896
50015,The Greater Cleveland Regional Transit Authority,Full Reporter,Urban,5597403,60888726,18836486,0,202185048,2514828,290022491,606716263,0,0,36786245,119361345,5077100,5539326,773480279,1063502770,60876739,25934685,11345000,31147861,657624,69085170,114218677,0,0,311490509,0,20782390,446491576,515576746,57651638,551151125
50016,Central Ohio Transit Authority,Full Reporter,Urban,173650670,59841316,4532405,1669056,0,0,239693447,264073768,0,0,0,63900606,16092234,0,344066608,583760055,49065292,7441913,0,14213953,2196166,23852032,0,0,0,174234227,86900,0,174321127,198173159,36378892,398273296
50017,Greater Dayton Regional Transit Authority,Full Reporter,Urban,13634724,31339917,6385461,2484071,11579867,0,65424040,160168827,0,0,0,29289672,21926749,470380,211855628,277279668,12318090,1572267,0,11712628,2473329,15758224,0,0,0,77134362,0,1494469,78628831,94387055,18139284,177071419
50021,Portage Area Regional Transportation Authority,Full Reporter,Urban,5727454,1798702,548110,120468,0,0,8194734,27964835,0,0,2940387,0,0,0,30905222,39099956,1704015,1037456,0,3270,139400,1180126,0,0,0,10938133,228809,0,11166942,12347068,2424713,26032190
50022,Toledo Area Regional Transit Authority,Full Reporter,Urban,9113310,18555410,1851931,103383,0,0,29624034,28907842,0,0,0,270467,0,14405001,43583310,73207344,8697841,4153465,0,1380436,0,5533901,0,0,0,38593650,0,0,38593650,44127551,14464422,23313212
50024,Western Reserve Transit Authority,Full Reporter,Urban,21666912,4803105,267083,164981,1006305,904953,28813339,22941764,0,0,0,0,0,0,22941764,51755103,2508232,84671,0,908905,242564,1236140,0,0,0,88922,0,14258425,14347347,15583487,2581413,36098435
50025,Duluth Transit Authority,Full Reporter,Urban,6955031,515782,313471,9475,0,3072460,10866219,50024283,0,0,0,0,0,0,50024283,60890502,0,1158680,0,1092312,18620,2269612,0,0,0,0,0,0,0,2269612,0,0
50027,Metro Transit ,Full Reporter,Urban,328195118,5037665,33092953,1675915,0,327703018,695704669,1577421766,0,0,184554862,1420542792,0,609244,3183128664,3878833333,69791578,238948090,0,839914,87685118,327473122,264397376,1418641,0,73434216,61493942,0,400744175,728217297,223850752,2996556862
50028,St. Cloud Metropolitan Transit Commission,Full Reporter,Urban,8868369,4383480,234405,118327,0,0,13604581,31116881,0,0,4613862,0,988763,0,36719506,50324087,405880,852241,740000,514114,2976887,5083242,2467434,0,0,3693222,375290,0,6535946,11619188,624538,38486241
50029,Bay Metropolitan Transit Authority,Full Reporter,Urban,3869849,1193824,208805,66943,0,0,5339421,3120162,0,0,0,103980,0,0,3224142,8563563,1463048,59782,0,873135,0,932917,0,0,0,7138743,0,0,7138743,8071660,676260,1278691
50031,Suburban Mobility Authority for Regional Transportation,Full Reporter,Urban,120583813,40959353,2979146,282284,18465149,0,183269745,143178939,5000,0,0,0,0,62254,143246193,326515938,27670543,7577693,0,20306816,5214989,33099498,0,0,0,179658538,4509805,271226,184439569,217539067,21227144,115420270
50032,Mass Transportation Authority ,Full Reporter,Urban,10702859,6565186,1435857,94193,0,0,18798095,66934287,0,0,0,0,0,0,66934287,85732382,335136,2784643,30000,432298,822374,4069315,593730,36270,0,1129769,879644,0,2639413,6708728,23440,79335350
50033,Interurban Transit Partnership,Full Reporter,Urban,27513058,3766690,579685,26625,0,6656940,38542998,156904402,302776,0,0,1147039,0,0,158354217,196897215,1326678,5340696,0,2648306,577146,8566148,0,0,0,4015145,0,0,4015145,12581293,21148422,164494178
50034,City of Jackson Transportation Authority,Full Reporter,Urban,2737482,16784,268445,29446,14142,0,3066299,2021416,0,0,0,0,0,0,2021416,5087715,416756,5383,0,119375,199741,324499,0,0,0,2459918,0,19262,2479180,2803679,119342,2581450
50035,Central County Transportation Authority,Full Reporter,Urban,3496280,5808115,489999,332061,967220,0,11093675,25833377,814545,0,37682923,9755,0,0,64340600,75434275,5930656,910017,96957,723134,208088,1938196,3854466,0,0,13451639,61755,0,17367860,19306056,3072335,58986540
50036,Capital Area Transportation Authority,Full Reporter,Urban,1847365,8830203,1448973,854145,20063700,0,33044386,48667261,0,0,0,601808,0,329492,49598561,82642947,34290284,2002829,20142,4688881,811076,7522928,0,0,0,0,0,79849424,79849424,87372352,5889196,23671683
50039,Saginaw Transit Authority Regional Service,Full Reporter,Urban,788357,2965028,312081,150272,0,0,4215738,4573486,0,0,0,0,0,0,4573486,8789224,219566,450361,134160,183247,290906,1058674,0,0,90217,0,0,193159,283376,1342050,205017,7461723
50040,Ann Arbor Area Transportation Authority,Full Reporter,Urban,23990560,4004625,910175,1081554,0,0,29986914,45830436,0,0,40943,1168755,0,0,47040134,77027048,3887,1956900,0,2852315,145257,4954472,0,0,0,454129,0,0,454129,5408601,402304,71220030
50044,Fort Wayne Public Transportation Corporation,Full Reporter,Urban,2884929,1909776,427332,195430,0,0,5417467,13368283,0,0,1290841,193030,0,16878,14869032,20286499,2530296,289272,0,1095004,607997,1992273,0,0,0,11361524,381364,7553324,19296212,21288485,2178237,-649927
50045,Gary Public Transportation Corporation,Full Reporter,Urban,562411,29355,195101,50222,0,658325,1495414,3051099,0,0,0,0,0,0,3051099,4546513,0,302879,0,119888,0,422767,0,0,0,0,0,0,0,422767,0,0
50047,Bloomington-Normal Public Transit System,Full Reporter,Urban,7135128,1470139,255083,449218,0,0,9309568,18556359,0,0,0,0,0,425536,18981895,28291463,0,390563,0,391254,761642,1543459,0,0,0,0,0,732724,732724,2276183,0,0
50050,Indianapolis and Marion County Public Transportation,Full Reporter,Urban,65059931,7312289,4224866,318790,21719864,0,98635740,305574542,0,0,0,39012551,0,16000000,360587093,459222833,0,6482327,1343199,5222768,308340,13356634,21127830,0,0,1079015,0,1891667,24098512,37455146,2148467,0
50051,Greater Lafayette Public Transportation Corporation,Full Reporter,Urban,4978915,3578964,477591,153915,0,0,9189385,26359837,0,0,2283160,706401,0,0,29349398,38538783,864450,333981,764188,332481,145561,1576211,51984,0,0,3677330,0,0,3729314,5305525,849533,33248175
50052,South Bend Public Transportation Corporation,Full Reporter,Urban,1182255,50610,516667,0,300000,0,2049532,27761903,0,0,0,26885,0,0,27788788,29838320,139470,258250,386242,0,547021,1191513,0,0,0,46080,0,0,46080,1237593,495204,28244993
50054,Muncie Indiana Transit System,Full Reporter,Urban,206134,16810,354384,62392,0,0,639720,5688957,0,0,0,0,0,0,5688957,6328677,398658,62876,0,45630,0,108506,0,0,12341,1908889,0,0,1921230,2029736,901614,3795985
50056,Greater Peoria Mass Transit District,Full Reporter,Urban,29418401,15857747,563316,188573,426360,0,46454397,16414403,0,0,0,0,0,0,16414403,62868800,7751791,2802727,0,2464887,0,5267614,0,0,0,4153596,16947921,0,21101517,26369131,2701021,41550439
50057,Rock Island County Metropolitan Mass Transit District,Full Reporter,Urban,2047160,4277299,8639,642826,0,0,6975924,78717677,0,0,0,0,0,0,78717677,85693601,3450633,542178,0,524501,1687269,2753948,0,0,1346742,3105883,154316,76248,4683189,7437137,770589,80936508
50058,Rockford Mass Transit District,Full Reporter,Urban,7722415,4446640,404116,120342,0,0,12693513,26424750,0,0,0,0,0,0,26424750,39118263,2516612,539725,2347470,902258,0,3789453,0,0,0,6980835,0,1799664,8780499,12569952,0,0
50059,Springfield Mass Transit District,Full Reporter,Urban,2655904,2693749,716284,160525,0,315840,6542302,32103600,0,0,462439,0,659025,0,33225064,39767366,3014762,231375,0,881106,0,1112481,380039,0,0,0,0,6948461,7328500,8440981,3596627,30744520
50060,Champaign-Urbana Mass Transit District,Full Reporter,Urban,5048158,22679349,1807420,1648811,3649619,0,34833357,59393999,131123,0,17663143,13195270,0,0,90383535,125216892,4632928,1199032,5962611,4218254,1147227,12527124,0,0,0,13150760,362823,0,13513583,26040707,5334703,98474410
50066,Chicago Transit Authority,Full Reporter,Urban,123850469,525225887,30766730,6041713,0,0,685884799,4237661742,0,0,634443727,936138957,20099,0,5808264525,6494149324,206447876,266836858,233195220,207408996,206726203,914167277,4572374641,0,57441635,1809248770,194437452,20000,6633522498,7547689775,22008395,-869100970
50104,Northern Indiana Commuter Transportation District,Full Reporter,Urban,19804144,48678246,7209914,3089623,3393656,0,82175583,294466958,0,0,41959444,194599571,9393287,0,540419260,622594843,474855,17488037,2355000,6474856,1050070,27367963,87297320,0,27732,1524795,0,0,88849847,116217810,425610,506426278
50110,Bloomington Public Transportation Corporation,Full Reporter,Urban,9220664,177297,352902,48322,0,626806,10425991,17089214,0,0,0,154642,0,0,17243856,27669847,0,93505,0,419517,0,513022,0,0,0,0,0,0,0,513022,0,0
50113,Pace - Suburban Bus Division,Full Reporter,Urban,14257318,83336213,8000511,2476227,42882339,2003274,152955882,314335742,0,0,551379,13970190,0,0,328857311,481813193,16164406,11628165,1200000,16505780,1784276,31118221,3600000,355673,0,29871081,32992735,25698403,92517892,123636113,6520779,367820707
50117,Laketran,Full Reporter,Urban,16136893,5592007,0,0,9954503,0,31683403,40495445,0,0,0,0,0,0,40495445,72178848,3357537,2125269,0,0,0,2125269,0,584335,0,17478118,0,0,18062453,20187722,14677124,40671539
50118,Northeast Illinois Regional Commuter Railroad Corporation,Full Reporter,Urban,90432238,177659911,25978772,7432315,269960226,0,571463462,3109390971,0,0,0,0,20022900,0,3129413871,3700877333,32309977,149395925,0,80044414,0,229440339,0,0,0,27849711,113778780,0,141628491,371068830,12237112,3349881368
50141,Detroit Transportation Corporation,Full Reporter,Urban,401592,8322111,3276069,555050,4684,0,12559506,25661753,0,0,1198191,1124667,2408087,0,30392698,42952204,2150594,1807742,1920,287819,4207281,6304762,524668,0,0,10602788,0,0,11127456,17432218,1223467,26447113
50146,Madison County Transit District,Full Reporter,Urban,10443,5016067,949670,869828,24015708,0,30861716,71545802,0,0,0,0,22967000,0,94512802,125374518,0,2860030,0,0,0,2860030,0,0,0,0,0,0,0,2860030,0,0
50148,Blue Water Area Transportation Commission,Full Reporter,Urban,8990078,5188096,774524,322530,0,0,15275228,26884474,0,0,0,9820,0,0,26894294,42169522,777205,1684303,0,519960,245787,2450050,0,0,0,2699520,0,242508,2942028,5392078,389615,37165034
50157,Butler County Regional Transit Authority,Full Reporter,Urban,2719624,1270411,39635,179247,0,0,4208917,8507114,0,0,0,60000,0,31779,8598893,12807810,1444744,201288,0,337971,101807,641066,0,0,0,6771915,0,0,6771915,7412981,1266983,5572590
50182,"Pace-Suburban Bus Division, ADA Paratransit Services",Full Reporter,Urban,5995723,15567259,0,1864330,0,0,23427312,2733698,0,0,0,0,0,0,2733698,26161010,1216145,4334105,0,14607751,3381819,22323675,0,315,0,1601730,364679,0,1966724,24290399,353058,2733698
50184,Macatawa Area Express Transportation Authority,Full Reporter,Urban,2893215,677900,0,85937,0,0,3657052,9170881,0,0,0,0,0,0,9170881,12827933,0,62614,0,144888,165905,373407,1417847,0,0,0,0,0,1417847,1791254,0,0
50199,Delaware County Transit Board,Full Reporter,Urban,3201075,359202,0,32218,0,0,3592495,5977310,0,0,0,0,0,39073,6016383,9608878,514021,15763,0,140565,590,156918,0,3067199,0,0,0,0,3067199,3224117,644652,6254130
50204,Jackson County Mass Transit District,Full Reporter,Urban,204789,267513,0,65609,0,0,537911,208071,0,0,0,0,0,0,208071,745982,0,29805,0,61311,161282,252398,0,0,0,0,0,0,0,252398,0,0
50209,Central Indiana Regional Transportation Authority ,Full Reporter,Urban,346403,0,0,0,0,0,346403,0,0,0,0,0,0,0,0,346403,0,0,0,0,0,0,0,0,0,0,0,0,0,0,0,0
50211,Rides Mass Transit District,Full Reporter,Urban,924772,2115978,0,763560,0,0,3804310,12726502,0,0,0,0,0,0,12726502,16530812,2530946,855248,0,0,2637760,3493008,0,0,0,1638553,0,0,1638553,5131561,0,0
50212,Stateline Mass Transit District,Separate Service,Urban,294643,586213,0,0,0,0,880856,307450,0,0,0,0,0,0,307450,1188306,0,117457,0,0,0,117457,0,0,0,0,0,0,0,117457,0,0
50518,SouthWest Transit,Full Reporter,Urban,6001103,2138028,230156,132010,0,0,8501297,42749889,0,0,8895128,0,0,0,51645017,60146314,220614,862441,0,79197,199252,1140890,0,35162,0,1996487,0,121190,2152839,3293729,102085,56971114
50519,Minnesota Valley Transit Authority,Full Reporter,Urban,20777702,6205,55285,545392,2000000,9041,23393625,50116669,0,0,0,0,0,0,50116669,73510294,271537,2778315,22796,88947,83682,2973740,3579601,0,40011,1522846,0,0,5142458,8116198,62744,65602889
50522,Lake Erie Transportation Commission,Full Reporter,Urban,1468806,19809,395076,176137,0,1368688,3428516,315761,0,0,0,0,1689614,0,2005375,5433891,0,10579,54717,88301,429121,582718,0,30000,0,0,0,0,30000,612718,0,0
60007,Fort Worth Transportation Authority,Full Reporter,Urban,31916364,19827079,2196303,2170882,0,0,56110628,1135168964,18046913,0,0,31114856,0,0,1184330733,1240441361,0,23631909,60252719,1198837,6340494,91423959,0,0,0,0,0,6120171,6120171,97544130,0,1142897231
60008,"Metropolitan Transit Authority of Harris County, Texas ",Full Reporter,Urban,10433095,134564776,41339021,0,497023144,0,683360036,2611761575,0,0,121944965,160439611,0,6048165,2900194316,3583554352,135108120,85187006,58180000,55017318,27409457,225793781,1184219981,0,0,889874775,0,10241652,2084336408,2310130189,108874775,1299657508
60011,VIA Metropolitan Transit,Full Reporter,Urban,219665420,55110360,5538225,30231,19002830,0,299347066,330567144,0,0,3495972,54239577,0,0,388302693,687649759,49710915,25791614,11365000,7100178,7379242,51636034,143756414,0,0,203124049,0,0,346880463,398516497,4003177,334841000
60022,Capital Area Transit System,Full Reporter,Urban,10019768,19100941,536509,131898,0,0,29789116,19567834,0,0,0,0,0,0,19567834,49356950,676430,1788865,608884,850652,906118,4154519,1585098,0,1585098,0,690136,0,3860332,8014851,0,0
60032,New Orleans Regional Transit Authority,Full Reporter,Urban,39185559,46467445,841419,3666670,4002639,0,94163732,265082322,0,0,0,11189541,8352072,8144429,292768364,386932096,1210607,1012640,3979471,3065688,21669626,29727425,21810619,0,0,602932,0,0,22413551,52140976,14010315,321991412
60033,Rock Region Metropolitan Transit Authority,Full Reporter,Urban,4292526,439011,483757,313822,0,0,5529116,37938720,0,0,0,0,0,0,37938720,43467836,0,175044,0,1217577,6629,1399250,0,0,0,0,0,0,0,1399250,0,0
60048,Capital Metropolitan Transportation Authority,Full Reporter,Urban,216803381,9861428,2806370,1905315,16762865,45077157,293216516,437317388,0,0,46,70779761,49288061,0,557385256,850601772,17229238,29198529,0,32666890,666085,62531504,0,0,549274,55703528,0,8529331,64782133,127313637,5071313,735446060
60051,Corpus Christi Regional Transportation Authority,Full Reporter,Urban,45627726,6681586,1123501,454705,0,0,53887518,65076126,0,0,0,973871,0,0,66049997,119937515,5592488,609511,870000,7823716,342276,9645503,18580000,0,0,733591,0,2023310,21336901,30982404,4706373,89841226
60056,Dallas Area Rapid Transit,Full Reporter,Urban,384037561,126873493,36869879,4216826,238658495,6374217,797030471,3766578151,0,0,102615991,405380091,112342378,12973605,4399890216,5196920687,92194520,103207750,188726664,0,126202136,418136550,3295992459,40167617,118716595,51025000,5047884,0,3510949555,3929086105,19208835,1340820267
60059,Brazos Transit District,Full Reporter,Urban,5830118,3539496,192817,0,0,0,9562431,40669881,0,0,0,0,0,0,40669881,50232312,463980,653418,862300,415334,0,1931052,5293244,0,0,0,0,0,5293244,7224296,0,0
60091,Hill Country Transit District,Full Reporter,Urban,4301753,670734,338283,0,0,0,5310770,11537908,0,0,0,0,0,0,11537908,16848678,0,102512,0,78697,0,181209,0,0,0,0,0,233617,233617,414826,0,0
60101,Denton County Transportation Authority,Full Reporter,Urban,39763409,10064934,194441,29805,5064346,0,55116935,276611283,17394147,0,0,20014332,0,25989,314045751,369162686,290447,1507478,2055000,1654920,677495,5894893,21405000,0,0,0,0,800000,22205000,28099893,70096,341283144
60102,Concho Valley Transit District,Full Reporter,Urban,969419,929805,0,0,0,0,1899224,9377990,0,0,208142,0,0,0,9586132,11485356,0,449546,550000,0,0,999546,0,0,0,0,0,0,0,999546,211748,0
60111,Rio Metro Regional Transit District,Full Reporter,Urban,9675323,19485824,0,0,0,0,29161147,3019214,0,0,0,0,0,0,3019214,32180361,0,7909860,0,0,0,7909860,10900000,0,0,0,0,0,10900000,18809860,0,0
70002,Transit Authority of Omaha,Full Reporter,Urban,10127745,28060335,1409205,506722,0,0,40104007,73963095,0,0,85110,0,0,0,74048205,114152212,3167362,2575737,0,1796924,0,4372661,0,0,0,11991558,1721510,0,13713068,18085729,6720908,92512937
70005,Kansas City Area Transportation Authority,Full Reporter,Urban,5529377,6976009,1684639,0,967350,1576000,16733375,135696831,0,0,43564839,0,0,0,179261670,195995045,9304811,4025178,0,5777133,2166886,11969197,0,0,0,37101345,2514300,0,39615645,51584842,8921213,144793801
70006,Bi-State Development Agency of the Missouri-Illinois Metropolitan District,Full Reporter,Urban,192820164,33295355,10928041,414958,13194102,0,250652620,808302299,0,0,0,34100681,158606504,64197,1001073681,1251726301,44937102,10693058,10445000,22836460,7451752,51426270,503589656,0,125818056,160986035,0,30917999,821311746,872738016,5256990,418668397
70010,Des Moines Area Regional Transit Authority,Full Reporter,Urban,7399171,27019631,826093,499865,0,0,35744760,48558546,0,0,0,1721915,0,0,50280461,86025221,3954410,731549,687710,1764169,2061717,5245145,0,0,5248017,11356809,0,0,16604826,21849971,25308318,42821342
70014,Topeka Metropolitan Transit Authority,Full Reporter,Urban,4702365,1894710,33983,228362,0,0,6859420,12753004,0,0,8970554,575844,0,0,22299402,29158822,768081,137466,0,423471,69678,630615,0,0,0,3284384,0,147671,3432055,4062670,221303,25642930
70066,Heart of Iowa Regional Transit Agency,Full Reporter,Urban,392332,1137015,0,0,0,0,1529347,1479985,0,0,0,0,0,0,1479985,3009332,0,762418,0,0,23541,785959,0,0,0,0,0,0,0,785959,34980,0
80001,Utah Transit Authority,Full Reporter,Urban,202454880,110108987,34422837,2448303,16457844,0,365892851,2746813249,54745003,0,0,137936777,134293260,29772838,3103561127,3469453978,140645019,23916849,45422209,18739476,11267778,99346312,2336203810,63779861,0,97186891,0,18685613,2515856175,2615202487,21967429,972929081
80006,Denver Regional Transportation District,Full Reporter,Urban,698525000,128994000,34253000,8163000,35097000,1655000,906687000,6466381000,0,0,0,133676000,127971000,0,6728028000,7634715000,61811000,89774000,77096000,46964000,17615000,231449000,3222791000,0,0,284791000,0,569848000,4077430000,4308879000,25655000,3361992000
80009,Missoula Urban Transportation District,Full Reporter,Urban,13290333,345894,291535,89038,0,0,14016800,10080581,0,0,0,0,0,0,10080581,24097381,0,112126,0,171794,36950,320870,0,0,0,0,0,440543,440543,761413,0,0
80012,Great Falls Transit District,Full Reporter,Urban,5620713,538217,107138,286148,0,0,6552216,4377600,0,0,17500,0,0,0,4395100,10947316,0,4120,0,285042,17400,306562,0,0,0,0,0,0,0,306562,0,0
80028,Cache Valley Transit District,Full Reporter,Urban,9756506,1366760,73000,13200,0,0,11209466,13119799,0,0,0,0,0,0,13119799,24329265,0,161566,0,88500,230000,480066,0,0,0,0,0,173000,173000,653066,0,0
90001,Regional Transportation Commission of Washoe County,Full Reporter,Urban,24799528,12721428,80566,363499,0,1231307,39196328,97755097,0,0,0,0,0,0,97755097,136951425,0,7194936,0,0,916688,8111624,0,3794848,0,5231129,0,0,9025977,17137601,0,0
90003,San Francisco Bay Area Rapid Transit District,Full Reporter,Urban,403543448,365088903,60940455,17331892,154485645,1848162,1003238505,7497031534,0,0,629274994,1689287939,0,13305164,9828899631,10832138136,210959536,236642184,62015000,110086082,25016945,433760211,2139177126,106060480,0,1113986927,63856546,64643058,3487724137,3921484348,91779319,7029834005
90004,Golden Empire Transit District,Full Reporter,Urban,17558552,5798988,1032997,215954,0,0,24606491,36406587,0,0,0,0,0,0,36406587,61013078,0,1342542,0,2173814,0,3516356,0,0,0,0,5949301,9453884,15403185,18919541,0,0
90006,Santa Cruz Metropolitan Transit District,Full Reporter,Urban,23377824,4855148,780278,871811,0,23099149,52984210,80175499,0,0,12520463,5279626,0,0,97975588,150959798,12406923,3612631,0,5026689,457540,9096860,0,12294891,919007,184998155,1870928,68442,200151423,209248283,613331,-46494893
90009,San Mateo County Transit District,Full Reporter,Urban,148587455,43179929,1682365,1749200,41230691,31587,236461227,178774984,0,0,0,5627142,95918938,0,280321064,516782291,20474322,10421916,10320000,17422392,25957781,64122089,194157818,0,0,101312557,13172986,0,308643361,372765450,5023518,159467645
90012,San Joaquin Regional Transit District,Full Reporter,Urban,7933794,22734319,938464,824008,0,6051,32436636,119571477,0,0,540977,6002,0,0,120118456,152555092,4489624,2224349,0,2411170,2746469,7381988,9800000,0,0,0,38813000,6721027,55334027,62716015,1910337,92418364
90013,Santa Clara Valley Transportation Authority,Full Reporter,Urban,157772000,70939000,28461000,6607000,681225000,0,945004000,4004819000,2203000,0,0,1179070000,0,66121000,5252213000,6197217000,125852000,26329000,15347000,5880000,25229000,72785000,137655000,0,0,380549000,0,0,518204000,590989000,23913000,5708167000
90014,Alameda-Contra Costa Transit District,Full Reporter,Urban,78518727,91609709,14157912,12177171,40017969,0,236481488,339504232,0,0,0,120372029,0,0,459876261,696357749,58074762,14492281,15611388,61093768,3461137,94658574,11655000,0,0,432675656,63409368,0,507740024,602398598,86304642,65729271
90016,"Golden Gate Bridge, Highway and Transportation District",Full Reporter,Urban,6029,22917995,4781815,1125740,0,0,28831579,156306344,0,0,0,80093961,0,0,236400305,265231884,7297422,4618423,0,5680668,1855582,12154673,408981,0,0,91623000,13200181,0,105232162,117386835,25281000,129861471
90019,Sacramento Regional Transit District,Full Reporter,Urban,23386865,44952824,24599990,415714,343561,0,93698954,814504224,0,0,68254531,29074668,3130438,0,914963861,1008662815,47954375,15919493,24473606,19407951,4035566,63836616,48242668,0,47338625,137113827,15737726,15397428,263830274,327666890,14682241,714268059
90020,Santa Barbara Metropolitan Transit District,Full Reporter,Urban,12411789,6733587,781354,292272,0,0,20219002,32456987,2174252,0,1185385,5408659,0,0,41225283,61444285,60006,775277,0,1174802,1788378,3738457,0,729023,1623202,1090192,3843420,1152290,8438127,12176584,64676,49263031
90023,Long Beach Transit,Full Reporter,Urban,53214214,6645110,2524437,1965252,0,0,64349013,80368099,0,0,0,2776119,28184651,0,111328869,175677882,14957584,2759016,0,1000440,62719369,66478825,0,0,0,34700421,4519745,17930345,57150511,123629336,0,0
90026,San Diego Metropolitan Transit System,Full Reporter,Urban,39047413,3250076,27858581,3009850,0,0,73165920,1743644037,0,0,0,0,0,0,1743644037,1816809957,39074841,17573146,2690000,11420631,10084,31693861,7665000,0,0,222040474,14799944,0,244505418,276199279,7346927,1572338592
90029,Omnitrans,Full Reporter,Urban,1470286,31721159,3096427,832422,0,0,37120294,176983883,0,0,0,25682383,62789342,0,265455608,302575902,12029811,11279191,0,1419090,7031824,19730105,0,8169827,0,31397511,0,44656635,84223973,103954078,2000825,208650810
90030,North County Transit District,Full Reporter,Urban,66653468,33624759,3720862,1910114,0,0,105909203,406830602,0,0,6647841,82467574,0,0,495946017,601855220,9135835,17711145,1300000,1919983,27053378,47984506,21750000,0,0,46240079,1558978,13518231,83067288,131051794,834243,479105018
90031,Riverside Transit Agency,Full Reporter,Urban,59278982,4097981,968136,269119,0,0,64614218,78936124,0,0,0,0,0,10187695,89123819,153738037,12597279,5557718,0,7649889,41583637,54791244,0,0,0,3094664,0,0,3094664,57885908,3013486,105435922
90035,Gold Coast Transit District,Full Reporter,Urban,4221191,8377011,539141,74640,0,0,13211983,65124187,0,0,6231818,71151,0,0,71427156,84639139,3392613,2321929,1985650,0,3817000,8124579,22834449,0,0,13322756,0,0,36157205,44281784,758789,42991179
90036,Orange County Transportation Authority,Full Reporter,Urban,451368960,137983933,2096197,21922139,0,0,613371229,260493067,0,0,10709368,941103,0,0,272143538,885514767,25763477,17391803,7260946,5430170,12619391,42702310,0,0,0,162545065,0,1050936,163596001,206298311,33931878,671048055
90045,Regional Transportation Commission of Southern Nevada,Full Reporter,Urban,21135707,139749122,0,529986,479116326,0,640531141,436726271,0,0,0,0,0,0,436726271,1077257412,25300924,83330996,57921970,18840607,413104,160506677,753368566,0,0,51424608,16252343,0,821045517,981552194,12966175,108039967
90061,Yuba-Sutter Transit Authority,Full Reporter,Urban,3158672,2062558,0,45498,0,0,5266728,16488581,0,0,0,0,0,0,16488581,21755309,486067,561810,0,42058,1964638,2568506,0,0,0,445606,0,25050,470656,3039162,15049,19187165
90062,Monterey-Salinas Transit,Full Reporter,Urban,13985945,12824904,357669,263812,0,0,27432330,62184515,0,0,0,2098268,0,8825,64291608,91723938,2949456,3295299,811909,2376523,2282658,8766389,2906706,0,0,14465221,1448381,0,18820308,27586697,1705276,65381421
90078,Central Contra Costa Transit Authority,Full Reporter,Urban,14990473,10002281,913142,95940,0,0,26001836,47502600,0,0,0,270476,0,0,47773076,73774912,3773761,2709540,0,2870949,17411699,22992188,0,0,0,9579911,0,4493432,14073343,37065531,3647380,36835762
90079,SunLine Transit Agency,Full Reporter,Urban,5605858,10586140,997219,705108,0,3023139,20917464,61208587,0,0,0,20405086,0,0,81613673,102531137,3490615,2868920,0,315056,13202908,16386884,2138846,0,0,242040,0,0,2380886,18767770,5043879,82210103
90088,Napa Valley Transportation Authority,Full Reporter,Urban,1496117,4140211,228482,50036,420286,0,6335132,21450570,0,0,0,0,0,0,21450570,27785702,0,1423164,0,2486393,508136,4417693,0,0,0,0,0,0,0,4417693,0,0
90090,Yolo County Transportation District,Full Reporter,Urban,6884628,5689329,0,0,0,0,12573957,25989390,0,0,1175706,0,0,0,27165096,39739053,560334,3010837,0,768834,0,3779671,0,0,0,1243879,0,0,1243879,5023550,100207,35175630
90093,Redding Area Bus Authority,Full Reporter,Urban,3865108,16158,79566,0,830282,0,4791114,12777405,0,0,0,0,0,0,12777405,17568519,0,1855764,1897366,16579,3000,3772709,0,0,0,0,0,0,0,3772709,0,0
90121,Antelope Valley Transit Authority,Full Reporter,Urban,22390573,14364286,522023,504143,0,0,37781025,65117280,0,0,0,12802608,0,0,77919888,115700913,678603,14665190,0,231982,0,14897172,0,0,0,1249556,0,412169,1661725,16558897,49692,99770927
90134,Peninsula Corridor Joint Powers Board,Full Reporter,Urban,107036773,104487630,7961987,0,2531761,0,222018151,912347576,0,0,0,1447512006,0,0,2359859582,2581877733,0,61686782,25000000,654632,91698068,179039482,55153344,0,0,0,0,0,55153344,234192826,0,0
90136,Regional Public Transportation Authority,Full Reporter,Urban,48971544,63512717,0,103175,22582146,10295000,145464582,99091739,0,0,14748715,6477045,17179733,62124,137559356,283023938,7786245,71302793,22392450,3385861,695682,97776786,112938160,0,0,32373847,0,387305,145699312,243476098,2487838,44846247
90144,Livermore / Amador Valley Transit Authority,Full Reporter,Urban,14915528,2953299,0,107297,0,1131458,19107582,27855717,0,0,0,29531332,0,0,57387049,76494631,792519,1485939,0,99169,545875,2130983,0,16277964,0,1188321,412630,684872,18563787,20694770,344032,56248348
90146,Foothill Transit,Full Reporter,Urban,26751988,8583546,0,1432356,0,0,36767890,225071295,0,0,0,0,81761713,650270,307483278,344251168,0,14897241,0,0,0,14897241,64215663,0,0,0,0,0,64215663,79112904,0,0
90148,Victor Valley Transit Authority,Full Reporter,Urban,15826916,11150601,0,216113,0,0,27193630,80687227,0,0,0,0,0,0,80687227,107880857,1382257,2702375,840000,1346248,8335723,13224346,32010901,0,0,0,161989,0,32172890,45397236,21220,63844658
90151,Southern California Regional Rail Authority,Full Reporter,Urban,19766161,115514618,16383539,608454,0,0,152272772,1392718641,0,0,0,0,51777865,479247,1444975753,1597248525,12884503,59886715,0,24770448,93264914,177922077,0,5810669,432828,13099940,0,14327000,33670437,211592514,3495443,1395045071
90154,Los Angeles County Metropolitan Transportation Authority ,Full Reporter,Urban,14866712,272924568,79216357,5642072,51806736,24772000,449228445,8633064143,0,0,1028570658,7819201713,392936775,12395026,17886168315,18335396760,207302040,267250086,333734682,316595111,204992806,1122572685,6251015386,0,0,1516751880,320883637,42938004,8131588907,9254161592,583727407,8704809801
90157,Access Services  ,Full Reporter,Urban,14645117,6430317,0,0,0,7350640,28426074,14993230,0,0,0,0,0,8946154,23939384,52365458,0,15857063,0,1723907,17615131,35196101,0,0,0,0,0,0,0,35196101,0,0
90159,Western Contra Costa Transit Authority,Full Reporter,Urban,3775417,1459546,0,27638,0,0,5262601,13634342,0,0,0,0,0,0,13634342,18896943,265667,1132021,0,42579,3685673,4860273,0,0,0,605112,0,402328,1007440,5867713,29763,13265134
90162,The Eastern Contra Costa Transit Authority,Full Reporter,Urban,3615877,1854836,725632,0,438585,0,6634930,29719476,0,0,0,0,0,6148,29725624,36360554,0,3794610,107721,419948,483659,4805938,1116656,0,0,0,303579,0,1420235,6226173,0,0
90164,Ventura County Transportation Commission,Full Reporter,Urban,1471494,534591,0,0,0,0,2006085,13071486,0,0,0,0,0,0,13071486,15077571,72086,1444307,0,9997,561759,2016063,0,0,0,175761,0,28924,204685,2220748,23873,12905036
90173,Transit Joint Powers Authority for Merced County,Full Reporter,Urban,9970348,406638,0,0,0,31249021,41626007,17560902,0,0,0,0,0,0,17560902,59186909,0,3259176,0,0,8366279,11625455,0,0,0,0,0,0,0,11625455,0,0
90182,Altamont Corridor Express,Full Reporter,Urban,50054263,19983895,1868225,3617544,0,0,75523927,208889327,0,0,0,0,2798864,0,211688191,287212118,0,12434364,5387700,24879367,0,42701431,42467269,47949,0,0,0,143016,42658234,85359665,0,0
90200,Kings County Area Public Transit Agency,Full Reporter,Urban,6374199,363667,0,212,0,0,6738078,11094202,0,0,409404,480641,0,0,11984247,18722325,106872,284433,328194,0,3610534,4223161,0,0,4062,0,0,0,4062,4227223,9333,14592641
90206,San Luis Obispo Regional Transit Authority,Full Reporter,Urban,5600935,6492584,228748,141924,0,2000,12466191,15344914,0,0,0,0,0,0,15344914,27811105,224410,495076,0,241987,8211523,8948586,0,0,0,653046,38645,2977744,3669435,12618021,27214,15390280
90209,"Valley Metro Rail, Inc.",Full Reporter,Urban,2500377,85582044,17259954,851526,0,49399,106243300,1315628259,0,0,21034142,367045849,0,0,1703708250,1809951550,0,84343589,10295000,11423470,13028954,119091013,14748714,0,0,0,921644,10868396,26538754,145629767,0,0
90211,Anaheim Transportation Network,Full Reporter,Urban,980505,4132653,217295,20440,0,281386,5632279,8730575,0,0,0,0,0,0,8730575,14362854,0,3961353,242187,813703,371182,5388425,2945808,0,0,0,0,0,2945808,8334233,0,0
90219,Northern Arizona Intergovernmental Public Transportation Authority,Full Reporter,Urban,1124188,2096982,303446,66537,0,0,3591153,30401853,0,0,0,946883,0,0,31348736,34939889,1412727,466899,0,677165,9711,1153775,0,0,0,6456563,0,1272884,7729447,8883222,417750,27051644
90223,"Paratransit, Inc.",Full Reporter,Urban,3829454,1704378,89426,497114,0,0,6120372,9462275,0,0,0,0,0,0,9462275,15582647,0,313810,213,381249,154458,849730,4188356,0,0,0,0,0,4188356,5038086,0,0
90225,San Francisco Bay Area Water Emergency Transportation Authority,Full Reporter,Urban,39918973,7928862,93215,4237183,0,0,52178233,427367597,0,0,0,16029547,0,0,443397144,495575377,1129621,3919499,0,4446797,4000,8370296,0,21011988,0,0,0,0,21011988,29382284,154262,467168452
90226,Imperial County Transportation Commission,Full Reporter,Urban,12576113,27882,0,0,0,0,12603995,5884575,0,0,0,0,0,0,5884575,18488570,0,0,0,0,500195,500195,0,0,0,0,0,0,0,500195,0,0
90232,Solano County Transit,Full Reporter,Urban,4221248,4691066,0,127322,1538554,0,10578190,49244903,0,0,0,51479,0,0,49296382,59874572,161752,1135307,0,138167,9420658,10694132,0,0,0,0,0,0,0,10694132,24251,49317941
90233,Yuma County Intergovernmental Public Transportation Authority,Full Reporter,Urban,257762,1883088,0,0,0,0,2140850,7413378,0,0,0,0,0,0,7413378,9554228,83536,1048338,0,0,2365361,3413699,0,0,0,407433,0,0,407433,3821132,25209,5791423
90234,Marin County Transit District,Full Reporter,Urban,22732623,13981421,7731,129151,0,0,36850926,39936608,0,0,0,206285,0,0,40142893,76993819,0,3751076,0,0,1047720,4798796,0,0,0,0,0,39301,39301,4838097,0,0
90299,Sonoma-Marin Area Rail Transit District,Full Reporter,Urban,38635854,32630971,1655419,1669200,23044127,2053528,99689099,547381109,271180,0,0,13519021,0,0,561171310,660860409,2747500,8261728,12845283,824250,3973238,25904499,135323000,0,0,4205499,0,219345,139747844,165652343,246990,497708576
91092,Tahoe Transportation District,Full Reporter,Urban,1447217,1078673,229856,13688,0,0,2769434,2478332,0,0,0,29127,0,0,2507459,5276893,0,262118,0,26363,0,288481,79088,0,0,0,0,0,79088,367569,0,0
99425,Pomona Valley Transportation Authority,Full Reporter,Urban,3832891,0,0,0,0,628489,4461380,628489,0,0,0,0,0,0,628489,5089869,0,0,0,0,0,0,0,0,0,0,1762480,0,1762480,1762480,0,0
