NTD ID,Agency Name,Reporter Type,Reporting Module,CA: Cash and Cash Equivalents,CA: Accounts Receivable,CA: Inventory,CA: Prepaid Expenses,CA: Current Investments and Current Portions of Long-Term Investments,CA: Other Current Assets,Total Current Assets,NCA: Capital Assets,NCA: Intangible Assets,NCA: Capital Leases Receivables,NCA: Special Funds,NCA: Work in Progress,NCA: Investments,NCA: Other Noncurrent Assets,Total Noncurrent Assets,Total Assets,Deferred Outflows of Resources,CL: Current Accounts Payable,CL: Short-Term Debt and Current Portions of Long-Term Debt,CL: Accrued Liabilities,CL: Other Current Liabilities,Total Current Liabilities,NCL: Long-Term Debt,NCL: Noncurrent Accounts Payable,NCL: Capital Lease Obligations,NCL: Long-Term Pension Liabilities,NCL: Estimated Liabilities,NCL: Other Noncurrent Liabilities,Total Noncurrent Liabilities,Total Liabilities,Deferred Inflows of Resources,Net Position
2,Spokane Transit Authority,Full Reporter,Urban,184734573,28496008,1755444,227972,0,0,215213997,118932303,3324333,0,0,36798510,0,32668001,191723147,406937144,10301314,5847882,0,7213100,1826011,14886993,0,0,382227,10767362,0,0,11149589,26036582,34896501,356305375
3,Pierce County Transportation Benefit Area Authority,Full Reporter,Urban,2481912,932509,4565603,985971,91166599,49216922,149349516,104565531,0,0,72275709,66075513,0,51675149,294591902,443941418,7155106,8345199,0,0,12236194,20581393,0,0,0,5209211,8142783,0,13351994,33933387,55647293,361515844
7,Lane Transit District,Full Reporter,Urban,29863490,28658518,1489549,976639,0,0,60988196,164521351,0,0,0,0,0,0,164521351,225509547,7613208,1641525,0,3985913,10852026,16479464,0,0,0,30576692,0,0,30576692,47056156,8115917,177950682
8,Tri-County Metropolitan Transportation District of Oregon,Full Reporter,Urban,322339910,61793786,57313165,9882864,30246350,108549958,590126033,2617903381,0,14345229,113450091,435860767,216364825,90400,3398014693,3988140726,234207114,45963205,25387645,40522143,105337710,217210703,867982384,2503220,18993,973274633,21352371,8918874,1874050475,2091261178,242409953,1888676709
11,Valley Regional Transit,Full Reporter,Urban,1586973,4766124,469593,40741,0,43289,6906720,30704210,0,0,0,2319560,0,0,33023770,39930490,736515,3024372,0,618304,659892,4302568,0,0,0,840000,0,0,840000,5142568,1386571,34137866
18,Ben Franklin Transit,Full Reporter,Urban,66279307,10883999,564304,328053,0,0,78055663,34029652,334943,0,0,2831889,0,17512706,54709190,132764853,2476272,2623093,0,1285774,0,3908867,0,0,0,1612029,0,5574073,7186102,11094969,17358480,106787676
19,Intercity Transit,Full Reporter,Urban,178170084,19386827,1160122,452068,0,0,199169101,62974203,0,0,0,41152159,0,20753120,124879482,324048583,6304411,3371683,0,1678498,385910,5436091,0,0,0,14728435,0,2707238,17435673,22871764,22098113,285383117
20,Kitsap Transit,Full Reporter,Urban,3975395,43854624,1867156,1186922,88915607,0,139799704,117271760,313500,0,145112,50347163,0,11151,168088686,307888390,3244816,2948878,3262677,4285126,0,10496681,32843485,0,0,7481551,0,0,40325036,50821717,2566155,257745334
21,Whatcom Transportation Authority,Full Reporter,Urban,38800480,7676811,1213100,293134,0,0,47983525,47142735,0,0,0,327075,0,15253813,62723623,110707148,2036733,482489,0,3365689,7483,3855661,0,0,0,1469230,0,229182,1698412,5554073,15728359,91461449
24,Clark County Public Transportation Benefit Area Authority,Full Reporter,Urban,0,23302345,2443957,1110848,0,0,26857150,112119260,6922671,0,147972060,10767119,0,23284689,301065799,327922949,3623073,2056653,0,5402404,312706,7771763,0,0,0,2208542,651204,629221,3488967,11260730,24309167,295976125
25,Salem Area Mass Transit District,Full Reporter,Urban,2780341,7592537,811601,555307,0,1829,11741615,39112926,0,0,0,7697333,27510733,0,74320992,86062607,3236607,1186375,0,3244447,172889,4603711,0,0,0,3635565,0,0,3635565,8239276,4907822,76152116
29,Snohomish County Public Transportation Benefit Area Corporation,Full Reporter,Urban,189315618,52388322,1881792,129476,0,0,243715208,230065023,7073838,0,1553000,60135930,166978633,53987936,519794360,763509568,12106302,10262789,1289304,9525535,3200869,24278497,6718927,0,0,20234017,2928373,0,29881317,54159814,57246656,664209400
34,Rogue Valley Transportation District,Full Reporter,Urban,17793846,6772845,582451,52,0,0,25149194,22373489,0,0,0,0,0,0,22373489,47522683,0,3811645,57563,3233710,0,7102918,214779,0,0,0,0,0,214779,7317697,0,0
40,Central Puget Sound Regional Transit Authority,Full Reporter,Urban,984654891,402754858,33082744,12975451,429793429,0,1863261373,7450071681,849419673,341959833,250053815,7250614595,858961398,21042049,17022123044,18885384417,7897805,391759479,58105000,52133369,20618945,522616793,2280687771,0,164710531,0,0,14288982,2459687284,2982304077,22599167,15888378978
43,Chelan Douglas PTBA ,Full Reporter,Urban,4592706,7052000,380588,139042,25231339,0,37395675,33221711,0,0,7721541,31836,0,0,40975088,78370763,1198976,1270767,0,855310,0,2126077,0,0,0,763527,0,51780,815307,2941384,7979409,68648946
44,Skagit Transit,Full Reporter,Urban,21266668,3931612,499470,0,0,0,25697750,27474134,264046,0,0,4000001,0,0,31738181,57435931,0,210186,0,868609,0,1078795,0,0,0,0,0,390107,390107,1468902,0,0
10001,Rhode Island Public Transit Authority,Full Reporter,Urban,6699524,15015393,1727327,1390949,2968645,0,27801838,110141094,0,0,3836276,26548704,3060433,2452226,146038733,173840571,26637303,6722429,2294756,9124409,279700,18421294,8025036,0,0,152384492,9905440,0,170314968,188736262,9314534,2427078
10003,Massachusetts Bay Transportation Authority,Full Reporter,Urban,401615524,289949743,53399364,5270167,261458925,264755879,1276449602,13399367894,0,30236792,0,0,0,802949790,14232554476,15509004078,561270788,297955038,749615000,294353050,0,1341923088,5087067493,0,72796057,3550261001,0,146153760,8856278311,10198201399,771451035,5100622432
10004,Brockton Area Transit Authority,Full Reporter,Urban,2788228,3968327,0,0,0,164108,6920663,20150591,0,0,0,0,0,1395884,21546475,28467138,444520,519308,0,208346,719564,1447218,6100000,0,0,951366,0,1147264,8198630,9645848,66246,19199564
10005,Lowell Regional Transit Authority,Full Reporter,Urban,1294217,3856340,0,189642,0,177041,5517240,37495323,0,0,0,0,0,2230695,39726018,45243258,0,831964,6000000,64726,0,6896690,0,0,0,1350941,0,300567,1651508,8548198,159254,0
10006,Southeastern Regional Transit Authority,Full Reporter,Urban,1668848,11710875,925221,162081,0,0,14467025,20408734,0,0,0,2398476,0,0,22807210,37274235,3122560,4305428,5506283,205713,0,10017424,0,0,0,9970871,889980,0,10860851,20878275,935468,18583052
10007,Berkshire Regional Transit Authority,Full Reporter,Urban,811195,5792731,0,11263,0,773741,7388930,12099807,0,0,0,0,0,0,12099807,19488737,257778,738241,5300000,117143,209567,6364951,0,0,0,900125,0,0,900125,7265076,0,0
10008,Pioneer Valley Transit Authority,Full Reporter,Urban,748939,28187006,0,447479,3946020,0,33329444,106599811,0,0,5644057,0,0,0,112243868,145573312,7803775,15200210,14500000,158461,3218311,33076982,0,0,0,43971993,0,0,43971993,77048975,9510976,66817136
10013,Merrimack Valley Regional Transit Authority,Full Reporter,Urban,1764158,9227063,0,143764,0,0,11134985,55285287,0,0,1074559,0,0,305390,56665236,67800221,399114,2685677,8739202,59508,0,11484387,305390,0,0,972984,0,725157,2003531,13487918,0,0
10014,Worcester Regional Transit Authority,Full Reporter,Urban,2746564,9831052,384062,19390,0,0,12981068,102395721,278816,0,0,0,0,0,102674537,115655605,2067463,1802267,10100000,162410,63994,12128671,0,0,0,13030805,8688110,0,21718915,33847586,972864,82902618
10016,Greater Portland Transit District,Full Reporter,Urban,2101946,1151859,341437,107788,0,0,3703030,14769007,0,0,0,107095,0,0,14876102,18579132,127603,408388,182500,338394,0,929282,1243000,0,0,770633,5000,213390,2232023,3161305,53508,15491922
10017,Greater Hartford Transit District,Full Reporter,Urban,86958,3003788,0,103903,1277147,0,4471796,36739910,0,0,0,0,5108589,0,41848499,46320295,0,5713253,0,145396,357380,6216029,0,0,0,928963,0,0,928963,7144992,0,0
10040,Southeast Area Transit District,Full Reporter,Urban,112122,107457,259115,136296,0,0,614990,10698464,0,0,0,0,0,0,10698464,11313454,0,161680,125219,118505,0,405404,0,0,0,0,0,0,0,405404,0,0
10042,Valley Transit District,Full Reporter,Urban,525179,105247,0,33685,0,26042,690153,4830985,0,0,0,0,0,0,4830985,5521138,0,0,0,76713,19190,95903,0,0,0,0,0,0,0,95903,0,0
10049,Greater New Haven Transit District,Full Reporter,Urban,1120660,725831,42959,83454,0,0,1972904,6678987,0,0,0,0,0,0,6678987,8651891,0,113169,0,479587,28034,620790,0,0,0,0,0,0,0,620790,0,0
10050,Greater Bridgeport Transit Authority,Full Reporter,Urban,3815884,2353375,1011678,26543,0,0,7207480,32119641,0,0,0,1131775,0,0,33251416,40458896,222648,826115,0,5453678,145040,6424833,0,0,0,11769143,487908,0,12257051,18681884,1418597,20581063
10051,Housatonic Area Regional Transit ,Full Reporter,Urban,1252402,1043715,94127,44201,0,0,2434445,36345612,0,0,0,0,1997438,0,38343050,40777495,0,323631,124762,181345,0,629738,92177,0,0,0,0,0,92177,721915,0,0
10053,Cape Ann Transportation Authority,Full Reporter,Urban,2431513,3005958,0,19400,0,235082,5691953,5737507,0,0,0,0,0,0,5737507,11429460,0,1131603,0,105799,0,1237402,2560000,0,0,0,0,1894551,4454551,5691953,0,0
10057,Norwalk Transit District,Full Reporter,Urban,127959,1706585,504261,92051,0,0,2430856,27068692,0,0,0,1092662,0,0,28161354,30592210,0,286672,2106973,1009556,0,3403201,0,0,0,0,141788,0,141788,3544989,0,0
10061,Montachusett Regional Transit Authority,Full Reporter,Urban,10250431,16614244,0,0,0,782121,27646796,49420937,0,0,0,0,0,0,49420937,77067733,0,18687697,19053333,483591,311949,38536570,210004,0,0,0,0,0,210004,38746574,0,0
10064,Greater Attleboro-Taunton Regional Transit Authority,Full Reporter,Urban,2630180,12574080,319737,12753,0,0,15536750,21388692,0,0,0,0,0,4566013,25954705,41491455,1220936,5923708,8200000,298913,50882,14473503,0,0,0,6347517,0,308087,6655604,21129107,1560209,20023075
10066,Green Mountain Transit Authority,Full Reporter,Urban,2428050,4015278,678458,393025,0,0,7514811,62132007,0,0,0,142448,0,0,62274455,69789266,203016,1112170,0,1380236,15668,2508074,0,0,0,0,0,0,0,2508074,0,0
10086,Cooperative Alliance for Seacoast Transportation,Full Reporter,Urban,1494157,608543,86865,39123,0,0,2228688,2610456,0,0,0,0,0,0,2610456,4839144,0,149269,0,252183,43787,445239,0,0,0,0,0,0,0,445239,0,0
10088,Casco Bay Island Transit District,Full Reporter,Urban,2314184,666954,78642,83168,0,0,3142948,10277549,0,0,2947935,6158169,0,0,19383653,22526601,0,435511,0,205964,2664,644139,0,0,0,0,0,1626053,1626053,2270192,0,0
10098,"Western Maine Transportation Services, Inc.",Full Reporter,Urban,705552,766341,106288,180942,0,0,1759123,2863627,0,0,0,271276,0,0,3134903,4894026,0,104159,98554,223757,0,426470,670633,0,0,0,0,304109,974742,1401212,0,0
10105,Cape Cod Regional Transit Authority,Full Reporter,Urban,384761,6169052,0,0,0,946688,7500501,27721986,199808,0,0,0,0,2347906,30269700,37770201,589691,1739731,102886,435939,0,2278556,7400000,563044,0,2112973,0,1910273,11986290,14264846,376756,23718290
10107,Milford Transit District,Full Reporter,Urban,239912,220440,0,0,0,0,460352,5374103,0,0,0,0,0,0,5374103,5834455,0,90577,0,58837,0,149414,5216684,0,0,0,0,128896,5345580,5494994,161404,0
10115,Northern New England Passenger Rail Authority,Full Reporter,Urban,3445987,1267498,3453,86396,0,0,4803334,13925687,0,0,0,635449,0,948405,15509541,20312875,689532,2391054,0,64493,0,2455547,0,0,0,2116543,0,0,2116543,4572090,58519,16371798
10118,MetroWest Regional Transit Authority,Full Reporter,Urban,1473390,8899386,0,552644,0,0,10925420,21538755,0,0,1307162,0,0,0,22845917,33771337,93478,1531792,0,224420,0,1756212,0,488687,0,2527051,0,9987682,13003420,14759632,0,0
10128,Connecticut Department of Transportation- CTTransit Waterbury- NET,Full Reporter,Urban,540766,1722790,1223318,297382,0,0,3784256,0,0,0,0,0,0,398204,398204,4182460,0,113531,1168209,915723,0,2197463,0,0,0,0,925953,0,925953,3123416,0,0
10183,"Woods Hole, Martha's Vineyard and Nantucket Steamship Authority",Full Reporter,Urban,13306704,2848745,681030,5059015,2702583,0,24598077,193604527,0,0,29797224,27102733,0,437714,250942198,275540275,5514938,9198302,8384302,5110721,8757187,31450512,73840739,0,0,24228762,0,0,98069501,129520013,7295547,144239653
20002,Capital District Transportation Authority,Full Reporter,Urban,16798457,17303319,0,0,0,4660019,38761795,133373467,0,0,16938687,0,0,0,150312154,189073949,21992137,9122970,0,0,3202655,12325625,0,0,1507550,85491074,9942000,5982206,102922830,115248455,32539915,63277716
20004,Niagara Frontier Transportation Authority,Full Reporter,Urban,60026000,84498000,5513000,1037000,0,0,151074000,298386000,0,0,10807000,0,0,0,309193000,460267000,78012000,16089000,3652000,0,9992000,29733000,8294000,0,0,461160000,37664000,465000,507583000,537316000,77087000,-76124000
20008,MTA New York City Transit,Full Reporter,Urban,27618969,1092243132,319519965,38718399,0,0,1478100465,41604154953,0,0,976249215,5048936445,0,0,47629340613,49107441078,3645945391,527141701,8127259,1352104265,252361338,2139734563,53180559,0,184984052,18794691635,3328000242,773465,22361629953,24501364516,3602311715,24649710238
20018,Central New York Regional Transportation Authority,Full Reporter,Urban,16555687,4870381,3955939,4582145,0,0,29964152,84291681,0,0,0,228668,0,33471874,117992223,147956375,91338446,1869816,0,3210333,400215,5480364,0,0,0,367486618,2392129,35400898,405279645,410760009,47225588,-218690776
20075,Port Authority Transit Corporation,Full Reporter,Urban,1576061,3974440,6915132,1288984,2805806,0,16560423,0,0,0,142500,0,0,0,142500,16702923,11860017,4099670,0,1722186,10799123,16620979,0,0,0,19964208,8866380,293706000,322536588,339157567,3411399,-314006026
20078,"Metro-North Commuter Railroad Company, dba: MTA Metro-North Railroad",Full Reporter,Urban,16792356,196019056,157622089,33211342,152807619,8228895,564681357,4480310898,0,0,0,1615996149,0,0,6096307047,6660988404,849198701,64608161,0,381979468,32391638,478979267,0,0,0,2701347454,45950001,49630460,2796927915,3275907182,132491891,4101788032
20080,New Jersey Transit Corporation,Full Reporter,Urban,172692690,46104551,142953866,0,16930799,296324236,675006142,4690234873,0,0,591864769,1887614274,0,5159245,7174873161,7849879303,595076765,214790881,144877590,118878708,95549049,574096228,1018265919,0,186582624,909741291,1993384979,133168843,4241143656,4815239884,99273753,3530442431
20098,Port Authority Trans-Hudson Corporation,Full Reporter,Urban,417883293,1075763131,52351138,162707035,686677287,39727186,2435109070,39201230435,0,0,0,881386086,2684641644,3914124877,46681383042,49116492112,1256726496,922540655,1086166665,913407992,348143,2922463455,26647422178,1236905000,0,1348891804,0,1065349313,30298568295,33221031750,1577794199,15574392659
20099,Staten Island Rapid Transit Operating Authority,Full Reporter,Urban,184312,55261938,1497788,1007216,0,0,57951254,326425514,0,0,0,325258572,0,0,651684086,709635340,46906104,3095157,0,14048788,25643338,42787283,0,0,0,119535379,18956903,0,138492282,181279565,17047563,558214316
20100,MTA Long Island Rail Road,Full Reporter,Urban,5476805,390690239,167116014,33201425,0,0,596484483,6547260503,0,0,0,3342196181,0,0,9889456684,10485941167,1046571349,95983906,3257039,187041782,8421598,294704325,20006826,0,0,4193868414,161809353,86795047,4462479640,4757183965,335429239,6439899312
20113,Regional Transit Service - Monroe County,Full Reporter,Urban,31457273,8019083,381066,1269246,15920318,0,57046986,142140467,0,0,0,0,13697368,4130118,159967953,217014939,27330749,3523800,0,4610922,11529378,19664100,0,0,0,61792,152363601,639162,153064555,172728655,23145809,48471224
20188,MTA Bus Company,Full Reporter,Urban,690086,238939167,14493842,5076115,0,87958160,347157370,410117621,0,0,0,0,0,403602957,813720578,1160877948,0,2512593,59040544,84331657,47779727,193664521,0,0,0,389923911,1396331128,0,1786255039,1979919560,0,0
20223,Cape May Lewes Ferry,Full Reporter,Urban,90210,216224,3682952,3526,21801061,65146,25859119,185063187,0,0,0,28102632,0,2853071,216018890,241878009,3845936,287717,3677960,1846876,2801614,8614167,158605496,0,0,2715614,0,927102,162248212,170862379,18171717,56689849
30001,Kanawha Valley Regional Transportation Authority,Full Reporter,Urban,15276640,1263834,466703,0,0,137657,17144834,11686051,0,0,0,0,667012,0,12353063,29497897,1488441,204651,0,743226,0,947877,0,0,0,9385370,0,0,9385370,10333247,2514362,18138729
30002,The Tri-State Transit Authority,Full Reporter,Urban,8719503,254852,379489,22260,0,617449,9993553,31497134,0,0,0,0,0,0,31497134,41490687,1113448,121982,0,576241,0,698223,0,0,0,0,0,0,0,698223,1748228,40157684
30006,Greater Richmond Transit Company,Full Reporter,Urban,33355472,8373592,898796,595914,0,0,43223774,67851920,690314,0,0,0,0,0,68542234,111766008,26724818,8055444,0,186856,16444316,24686616,0,0,0,80451740,172475,558521,81182736,105869352,6373516,26247958
30007,Greater Roanoke Transit Company,Full Reporter,Urban,877990,3415756,512702,137716,0,0,4944164,16577151,0,0,0,0,0,0,16577151,21521315,0,1045437,0,385026,1330234,2760697,0,0,0,0,0,0,0,2760697,0,0
30008,Greater Lynchburg Transit Company,Full Reporter,Urban,640629,434084,308182,302384,0,0,1685279,35554427,0,0,0,0,0,0,35554427,37239706,15680,779444,0,163207,71316,1013967,0,109094,0,0,0,201653,310747,1324714,149376,35781296
30010,Lehigh and Northampton Transportation Authority,Full Reporter,Urban,17302573,2729151,611425,14633969,0,0,35277118,46523021,0,0,0,0,0,0,46523021,81800139,2734611,3331573,180254,1979922,16402275,21894024,0,0,0,11314618,0,14337209,25651827,47545851,4385299,32603600
30011,Altoona Metro Transit,Full Reporter,Urban,1048477,1746947,223738,28776,3568038,0,6615976,14744465,0,0,0,0,570742,0,15315207,21931183,189100,342862,0,469902,0,812764,0,0,0,0,0,5467477,5467477,6280241,590745,15249297
30012,Cambria County Transit Authority,Full Reporter,Urban,7707039,1421186,521076,288011,0,0,9937312,35265374,0,0,0,0,0,0,35265374,45202686,328586,380535,0,246157,0,626692,0,0,0,473550,0,8797637,9271187,9897879,1187369,34446024
30013,Erie Metropolitan Transit Authority,Full Reporter,Urban,10236757,7651966,165342,381908,0,0,18435973,82114040,0,0,0,0,0,1744712,83858752,102294725,2072745,1151354,0,1711833,14182585,17045772,0,0,0,514641,0,6450025,6964666,24010438,3537314,76819718
30014,Cumberland Dauphin-Harrisburg Transit Authority,Full Reporter,Urban,9885203,1218944,401052,662156,0,0,12167355,29592383,0,0,0,0,0,75915,29668298,41835653,1869903,478370,0,1068734,10240862,11787966,0,0,0,0,578144,394040,972184,12760150,4160949,26784457
30015,Luzerne County Transportation Authority,Full Reporter,Urban,5914398,748292,451166,330343,0,0,7444199,18700400,0,0,0,0,0,0,18700400,26144599,968588,135967,0,490216,6203368,6829551,0,0,0,610510,0,7267413,7877923,14707474,460468,11945245
30019,Southeastern Pennsylvania Transportation Authority,Full Reporter,Urban,42026734,189268629,96833665,24153549,25508855,331575256,709366688,4180492669,0,0,44112564,583289470,0,2886371,4810781074,5520147762,530316742,110682246,40783958,150005592,457316570,758788366,569853475,0,29428746,1008318784,129900941,1496621527,3234123473,3992911839,455220304,1602332361
30022,Port Authority of Allegheny County,Full Reporter,Urban,116096511,88916089,18113294,927688,0,0,224053582,1234692829,0,0,0,0,0,50504257,1285197086,1509250668,149756242,15148954,12590000,21087818,200550296,249377068,130454860,0,0,310238835,0,527388815,968082510,1217459578,252777531,188769801
30023,Beaver County Transit Authority,Full Reporter,Urban,1634426,5893993,271980,211144,0,0,8011543,20524416,0,0,0,3399272,0,0,23923688,31935231,0,617829,0,371306,0,989135,0,0,0,0,12563,0,12563,1001698,5723082,0
30025,County of Lackawanna Transit System,Full Reporter,Urban,6866249,141293,410167,444411,292879,2045997,10200996,23442000,0,0,0,0,0,0,23442000,33642996,5881,240021,0,1219578,9448934,10908533,175000,0,0,2108750,0,769009,3052759,13961292,0,0
30027,Central Pennsylvania Transportation Authority,Full Reporter,Urban,5690605,16973125,359284,421935,0,0,23444949,45219616,0,0,0,1734935,0,0,46954551,70399500,0,3407878,0,1117136,15955283,20480297,0,0,0,0,0,0,0,20480297,0,0
30030,Washington Metropolitan Area Transit Authority,Full Reporter,Urban,1379749631,218314245,153011554,0,2523202,0,1753598632,13346414179,0,0,0,0,0,0,13346414179,15100012811,862644945,397743671,27315000,423865729,70557735,919482135,2651260671,40915440,0,3399969779,136969335,36617949,6265733174,7185215309,263242339,8514200108
30035,Ohio Valley Regional Transportation Authority,Full Reporter,Urban,5363955,1056353,82585,59636,715298,27483,7305310,2624161,0,0,773038,0,0,0,3397199,10702509,601420,0,117978,786965,136479,1041422,0,0,27775,711776,0,165189,904740,1946162,266663,9091104
30045,"JAUNT, Inc.",Full Reporter,Urban,2047595,4359268,0,127891,0,0,6534754,7237496,0,0,0,0,0,0,7237496,13772250,0,1087067,0,514780,0,1601847,0,0,0,0,0,0,0,1601847,0,0
30054,Centre Area Transportation Authority,Full Reporter,Urban,8264936,4621547,105782,405740,0,0,13398005,56851842,0,0,0,0,0,0,56851842,70249847,0,417687,0,943436,0,1361123,0,0,125852,0,0,0,125852,1486975,12809712,0
30061,Mid Mon Valley Transit Authority,Full Reporter,Urban,888964,3346507,2500,0,0,0,4237971,14215435,346720,0,0,0,0,0,14562155,18800126,0,0,0,0,3826771,3826771,0,0,0,0,0,0,0,3826771,0,0
30070,Potomac and Rappahannock Transportation Commission,Full Reporter,Urban,13244225,36606480,0,165756,0,13792050,63808511,85313391,0,0,0,0,0,0,85313391,149121902,964494,5655872,275000,667085,17543629,24141586,338396,0,0,1170256,0,543940,2052592,26194178,32380,123859838
30073,Virginia Railway Express,Full Reporter,Urban,113216934,24074222,2883469,522050,0,63074,140759749,326005770,0,0,14781469,0,0,1355853,342143092,482902841,362566,5568486,4104230,1367085,1637050,12676851,41973371,0,5355739,880655,364601,831971,49406337,62083188,47629,421134590
30075,Delaware Transit Corporation,Full Reporter,Urban,6751758,8039716,4610974,52749,0,0,19455197,155017679,0,0,59723,9271679,11369769,0,175718850,195174047,25142708,8548602,0,7162032,0,15710634,0,3001998,0,180683971,0,5821019,189506988,205217622,72229866,-57130733
30076,Williamsburg Area Transit Authority,Full Reporter,Urban,3194322,758233,0,0,0,0,3952555,8944888,0,0,0,2138770,0,0,11083658,15036213,346816,397113,0,0,557467,954580,0,0,0,0,0,0,0,954580,17373,14411076
30083,Transportation District Commission of Hampton Roads,Full Reporter,Urban,0,28820882,10573205,1814831,406452,0,41615370,256842329,49226,0,0,7442205,1000,0,264334760,305950130,4621356,15077264,8483012,12986165,50856163,87402604,0,0,895943,9688197,0,5438349,16022489,103425093,56582,207089811
30095,County of Lebanon Transit Authority,Full Reporter,Urban,4176087,274390,114661,126643,0,0,4691781,6270235,0,0,0,0,0,0,6270235,10962016,0,239597,0,106852,4377022,4723471,0,0,0,0,0,0,0,4723471,0,0
30096,The Tri-County Council for the Lower Eastern Shore of Maryland,Full Reporter,Urban,2515398,0,0,0,0,0,2515398,17427589,0,0,0,0,0,0,17427589,19942987,0,0,0,0,84261,84261,0,0,0,0,0,0,0,84261,0,0
30111,Washington County Transportation Authority,Full Reporter,Urban,2426324,872707,0,15361,0,106,3314498,8103614,0,0,0,0,0,0,8103614,11418112,0,390985,0,18003,0,408988,0,0,0,0,0,2470678,2470678,2879666,0,0
30137,Monroe County Transportation  Authority,Full Reporter,Urban,3643152,742204,129957,52064,0,0,4567377,9517512,0,0,0,0,0,0,9517512,14084889,0,3749812,0,0,0,3749812,0,0,0,0,0,0,0,3749812,0,0
30202,South Central Transit Authority,Full Reporter,Urban,40413942,4261156,818532,131391,0,1541778,47166799,92983672,0,0,0,0,0,2820185,95803857,142970656,1363198,1498299,0,1290054,40845661,43634014,0,0,0,2029685,0,0,2029685,45663699,4550941,94119214
40004,Metropolitan Transit Authority,Full Reporter,Urban,5291154,4979720,2982464,1420871,0,0,14674209,158294953,0,0,0,8729213,350000,0,167374166,182048375,29001549,1929138,3000000,7525896,250314,12705348,0,0,0,119299017,0,6787449,126086466,138791814,3625479,68632631
40006,Cape Fear Public Transportation Authority,Full Reporter,Urban,227789,761986,200569,107669,0,0,1298013,28297541,0,0,0,46827,0,0,28344368,29642381,279870,174064,0,326890,0,500954,0,0,0,489204,0,0,489204,990158,7472,28924621
40012,City of Winston Salem,Full Reporter,Urban,4095017,10337847,281716,0,0,0,14714580,30199410,0,0,0,0,0,0,30199410,44913990,0,7878216,0,0,124613,8002829,0,0,0,0,0,0,0,8002829,0,0
40014,Ms Coast Transportation Authority,Full Reporter,Urban,2326114,676043,2206742,251102,0,0,5460001,20825837,0,0,0,11406933,0,0,32232770,37692771,0,377128,0,339117,0,716245,0,0,0,0,0,0,0,716245,0,0
40017,Lexington Transit Authority,Full Reporter,Urban,15857299,6611809,714316,27460,0,0,23210884,37826299,0,0,0,0,0,0,37826299,61037183,1757884,648155,0,675134,0,1323289,0,0,0,0,0,0,0,1323289,3420438,58051340
40018,Transit Authority of River City,Full Reporter,Urban,8583711,13740629,1708613,277251,0,0,24310204,76166345,0,0,0,0,31000,0,76197345,100507549,29017202,14506489,140841,3052575,1556893,19256798,121697,0,0,96853416,5880195,30198452,133053760,152310558,9141960,-31927767
40019,Transit Authority of Northern Kentucky,Full Reporter,Urban,1066991,40750,666301,93283,9216192,121747,11205264,35610192,0,0,0,152272,313000,0,36075464,47280728,1690679,1014535,0,467760,116126,1598421,0,69544,0,14231321,161000,1115683,15577548,17175969,2393174,29402264
40022,Metropolitan Atlanta Rapid Transit Authority,Full Reporter,Urban,11135032,159887172,36632889,9549607,641375873,170571586,1029152159,2723658996,0,0,0,335300946,351513398,75957291,3486430631,4515582790,75064954,128664773,0,26790966,129156085,284611824,2335373622,0,370631510,67667293,0,129546723,2903219148,3187830972,122451803,1280364969
40025,Chatham Area Transit Authority,Full Reporter,Urban,4920602,10162978,478352,208566,4017809,0,19788307,47794181,0,0,0,0,0,0,47794181,67582488,213636,5822613,0,403744,1110439,7336796,0,0,0,1071622,0,75000,1146622,8483418,108445,59204261
40027,Pinellas Suncoast Transit Authority,Full Reporter,Urban,50224542,15617378,2716943,511626,0,0,69070489,111247727,0,0,0,0,0,0,111247727,180318216,10824927,5975304,0,2788847,4340199,13104350,0,0,0,18258117,1443805,6188066,25889988,38994338,21957769,130191036
40031,Lakeland Area Mass Transit District ,Full Reporter,Urban,1030132,2357788,282812,236329,4446983,0,8354044,13105137,0,0,0,22849,1254328,0,14382314,22736358,3709835,420339,273912,146780,81348,922379,0,0,953840,8409783,0,500716,9864339,10786718,290097,15369378
40035,Central Florida Regional Transportation Authority,Full Reporter,Urban,104298947,21778365,2755265,0,0,5851008,134683585,145638387,0,0,0,9959283,4428552,4501730,164527952,299211537,6241452,10131306,8526827,923209,3140800,22722142,0,0,0,6282534,8714437,0,14996971,37719113,8398773,259335103
40040,Jacksonville Transportation Authority,Full Reporter,Urban,0,15496968,2994904,1109167,0,13730964,33332003,153738111,0,0,0,129481723,0,2575579,285795413,319127416,13959710,10931129,0,6556458,1823548,19311135,0,690803,0,185878823,510341,0,187079967,206391102,5666573,121029451
40041,Hillsborough Area Regional Transit Authority,Full Reporter,Urban,251209650,8627639,2160769,565963,0,0,262564021,96178680,0,0,0,8206207,0,0,104384887,366948908,13425823,5562045,83659,2228657,2930385,10804746,0,0,0,24453731,6515681,0,30969412,41774158,27172356,311428217
40042,Birmingham-Jefferson County Transit Authority,Full Reporter,Urban,10737934,3893181,1244371,284028,0,0,16159514,50683696,0,0,0,1310450,0,9950,52004096,68163610,3808122,3597603,0,522690,3171783,7292076,0,0,0,29059513,0,0,29059513,36351589,1710811,33909332
40053,Greenville Transit Authority,Full Reporter,Urban,5982043,597725,338626,100321,0,0,7018715,11315875,0,0,0,902886,0,0,12218761,19237476,0,936936,0,0,10224,947160,0,0,0,0,0,0,0,947160,0,0
40057,Jackson Transit Authority,Full Reporter,Urban,329877,800606,143493,96517,0,0,1370493,6305921,0,0,0,0,0,0,6305921,7676414,418047,49282,0,271454,0,320736,0,0,0,1240440,0,0,1240440,1561176,204727,6328558
40077,South Florida Regional Transportation Authority,Full Reporter,Urban,78238138,37159061,0,1753832,0,0,117151031,560530078,0,0,0,0,0,0,560530078,677681109,3776592,12459494,0,5954002,6365103,24778599,30427002,0,0,10952539,0,11225758,52605299,77383898,1546060,602527743
40086,Metropolitan Bus Authority,Full Reporter,Urban,6576580,668190,5885734,0,0,0,13130504,19737151,0,0,0,3552308,0,0,23289459,36419963,13555043,110699882,465803,20544337,0,131710022,282440040,0,0,2467078,0,2089876,286996994,418707016,24311973,-393043983
40100,Santee Wateree Regional Transportation Authority,Full Reporter,Urban,287192,306051,0,39882,0,0,633125,14037288,0,0,481392,0,0,0,14518680,15151805,492716,46812,0,0,0,46812,356154,0,0,0,0,0,356154,402966,5635540,9606015
40108,Research Triangle Regional Public Transportation Authority,Full Reporter,Urban,75809560,56720399,1204001,140030,391271712,0,525145702,58734126,0,0,0,0,0,26003104,84737230,609882932,0,14955858,1258775,0,0,16214633,5933745,0,0,0,0,0,5933745,22148378,524681,0
40110,Charleston Area Regional Transportation Authority,Full Reporter,Urban,4672669,7932838,32099,326106,0,0,12963712,29314030,0,0,0,0,0,0,29314030,42277742,2409,2590974,0,36848,132443,2760265,1563121,0,0,173017,0,0,1736138,4496403,24581,37759167
40141,Central Midlands Regional Transportation Authority,Full Reporter,Urban,9940002,6818939,132606,145391,0,15831,17052769,25897048,0,0,0,0,19886175,0,45783223,62835992,495109,8979240,0,58484,36707,9074431,0,0,12113,1812233,0,28841,1853187,10927618,227496,52175987
40159,Regional Transportation Authority,Full Reporter,Urban,5551536,811255,434672,43095,0,0,6840558,39444311,0,0,0,0,0,0,39444311,46284869,0,703289,0,24500,2284334,3012123,0,0,0,0,0,0,0,3012123,0,0
40172,Western Piedmont Regional Transit Authority ,Full Reporter,Urban,5292240,1247475,0,0,0,1303,6541018,1716507,0,0,0,0,0,0,1716507,8257525,585399,225021,0,106808,28889,360718,0,0,0,1030933,0,68171,1099104,1459822,25921,7357181
40173,Piedmont Authority for Regional Transportation,Full Reporter,Urban,13677123,2073031,0,0,0,0,15750154,26846509,0,0,0,0,0,0,26846509,42596663,0,1501169,0,3450,72051,1576670,0,0,0,0,0,110845,110845,1687515,0,40909148
40191,Transit Authority of Central Kentucky,Full Reporter,Urban,1938878,417773,0,0,0,20613,2377264,6189323,0,0,0,0,0,0,6189323,8566587,0,53350,0,94676,58855,206881,0,0,0,0,0,8359706,8359706,8566587,0,0
40200,Tampa Bay Area Regional Transit Authority,Full Reporter,Urban,307791,874677,0,0,0,0,1182468,20821,0,0,0,0,0,0,20821,1203289,0,468459,0,22866,34235,525560,0,0,0,0,0,121850,121850,647410,0,0
40950,First Tennessee Human Resource Agency,Full Reporter,Urban,5354780,1868221,0,0,0,0,7223001,479200,0,0,0,0,0,0,479200,7702201,0,36040,0,0,0,36040,0,0,0,0,0,0,0,36040,0,0
50010,METRO Regional Transit Authority ,Full Reporter,Urban,96257136,24864165,1267003,1755445,0,0,124143749,159639374,0,0,0,4113281,0,0,163752655,287896404,3485891,619809,0,3117514,230514,3967837,0,0,0,19171267,66667,0,19237934,23205771,336801,267839723
50011,Stark Area Regional Transit Authority,Full Reporter,Urban,5136332,106717,482239,688229,7063388,4634172,18111077,39983107,25372,0,0,9517538,0,92230,49618247,67729324,4423106,1326085,0,1749459,1860872,4936416,0,0,0,18716622,0,0,18716622,23653038,4289306,44210086
50012,Southwest Ohio Regional Transit Authority,Full Reporter,Urban,0,67921309,1599162,853543,57484011,0,127858025,109168634,0,0,0,825533,37987180,734660,148716007,276574032,18759887,2710303,0,19521759,8576360,30808422,0,4354773,0,115326766,0,1968251,121649790,152458212,22359564,120516143
50015,The Greater Cleveland Regional Transit Authority,Full Reporter,Urban,11715766,69824100,19627398,0,136255377,2132445,239555086,584069558,0,0,126892572,163326508,22894960,21732382,918915980,1158471066,30838298,25186019,9535000,29407667,618803,64747489,45455990,0,0,143233997,0,21085454,209775441,274522930,119068122,795718312
50016,Central Ohio Transit Authority,Full Reporter,Urban,306798620,49304791,4550855,1942759,0,0,362597025,258970849,0,0,0,30941924,26537646,0,316450419,679047444,23391520,4410461,0,18139781,83289,22633531,0,0,0,69037032,195929,0,69232961,91866492,68788905,541783567
50017,Greater Dayton Regional Transit Authority,Full Reporter,Urban,19188132,40858414,7026721,1659787,16158413,0,84891467,149862342,0,0,0,39431358,42327402,4851002,236472104,321363571,8720343,2103284,0,12858712,1652818,16614814,0,0,0,35536702,0,1243663,36780365,53395179,29517474,247171261
50021,Portage Area Regional Transportation Authority,Full Reporter,Urban,7484965,1957804,482105,212820,0,0,10137694,28415803,0,0,5997896,0,0,546696,34960395,45098089,858075,21123,0,138278,0,159401,0,0,0,4568065,317272,0,4885337,5044738,4195100,36716326
50022,Toledo Area Regional Transit Authority,Full Reporter,Urban,18277896,17332350,615947,440276,0,0,36666469,19874723,0,0,0,595894,0,0,20470617,57137086,2387233,3805188,0,1027304,582930,5415422,0,0,0,10846251,0,0,10846251,16261673,10968611,32294035
50024,Western Reserve Transit Authority,Full Reporter,Urban,22442739,5354362,282639,196500,8977913,95764,37349917,22793067,0,0,0,0,0,11000,22804067,60153984,2494793,214406,0,1293538,477396,1985340,0,0,0,992454,0,9205214,10197668,12183008,5485955,44979814
50025,Duluth Transit Authority,Full Reporter,Urban,5039036,681201,390206,0,0,2436443,8546886,44994838,0,0,0,0,0,0,44994838,53541724,0,1068361,0,1139674,176578,2384613,0,0,0,0,0,0,0,2384613,0,0
50027,Metro Transit ,Full Reporter,Urban,399350731,5582189,28361267,7944669,0,838856059,1280094915,1631998024,0,11927627,64294966,1817001519,0,547127,3525769263,4805864178,168239363,239631591,0,1131633,94708565,335471789,279504600,1299601,12120222,0,393300497,0,686224920,1021696709,268935457,3683471375
50028,St. Cloud Metropolitan Transit Commission,Full Reporter,Urban,16503596,2666204,215072,344,0,0,19385216,30748694,0,0,3833274,0,0,0,34581968,53967184,526680,595800,0,395412,900243,1891455,0,0,0,4232793,372739,0,4605532,6496987,166199,47830678
50029,Bay Metropolitan Transit Authority,Full Reporter,Urban,5170777,1258234,205759,64413,0,0,6699183,4776442,0,0,0,87132,0,620305,5483879,12183062,1574723,164913,0,813096,0,978009,0,0,0,5754912,0,0,5754912,6732921,1524553,5500311
50031,Suburban Mobility Authority for Regional Transportation,Full Reporter,Urban,120837739,53642169,3208125,277105,18405036,0,196370174,158495066,5000,0,0,0,0,101639,158601705,354971879,36178049,12545376,0,13799987,6965070,33310433,0,0,0,112866833,9212837,425953,122505623,155816056,69210576,166123296
50032,Mass Transportation Authority ,Full Reporter,Urban,14622089,6759267,1311103,53545,0,122116,22868120,64343701,0,0,0,0,0,0,64343701,87211821,261293,903752,151250,956499,779162,2790663,514359,156380,0,0,1376426,0,2047165,4837828,939155,81696131
50033,Interurban Transit Partnership,Full Reporter,Urban,46149497,3098115,578826,797464,0,12192649,62816551,157687889,423814,0,0,171714,0,0,158283417,221099968,996227,10455593,0,2598871,787855,13842319,0,0,0,739049,0,0,739049,14581368,22911710,184603117
50034,City of Jackson Transportation Authority,Full Reporter,Urban,1688290,1602023,302791,27681,53679,0,3674464,1953525,0,0,0,0,0,0,1953525,5627989,596259,45492,0,50276,473459,569227,0,0,0,2404522,0,17181,2421703,2990930,391478,2841840
50035,Central County Transportation Authority,Full Reporter,Urban,5007744,8352614,469090,327572,969296,0,15126316,23877367,497955,0,45732859,56137,0,0,70164318,85290634,4321351,734830,99630,596533,929162,2360155,3754836,0,0,15707356,46065,92404,19600661,21960816,2488421,65162748
50036,Capital Area Transportation Authority,Full Reporter,Urban,2837949,12397300,1367447,681513,22914609,0,40198818,51311996,0,0,0,248178,0,4903409,56463583,96662401,26918945,2009113,0,3330018,584173,5923304,0,0,0,0,0,73342209,73342209,79265513,15076304,29239529
50039,Saginaw Transit Authority Regional Service,Full Reporter,Urban,1580244,3150119,356238,168465,0,0,5255066,4700218,0,0,0,0,0,0,4700218,9955284,154067,195136,102473,844541,435003,1577153,0,0,26341,0,0,179709,206050,1783203,154067,8172081
50040,Ann Arbor Area Transportation Authority,Full Reporter,Urban,35414775,9023713,1101106,537811,0,0,46077405,45095949,0,0,40943,1324360,0,0,46461252,92538657,27295,3093911,0,2980087,145257,6219255,0,0,0,87386,0,0,87386,6306641,640041,85619270
50044,Fort Wayne Public Transportation Corporation,Full Reporter,Urban,3756467,1460266,447493,191974,0,0,5856200,12354860,0,0,1184363,0,0,16878,13556101,19412301,1881131,218814,0,1095111,600000,1913925,0,0,0,7557893,365126,6305522,14228541,16142466,5422314,-271348
50045,Gary Public Transportation Corporation,Full Reporter,Urban,449133,13963,211305,62091,0,894566,1631058,2791099,0,0,0,0,0,0,2791099,4422157,0,252493,0,123839,0,376332,0,0,0,0,0,0,0,376332,0,0
50047,Bloomington-Normal Public Transit System,Full Reporter,Urban,7788227,877012,282022,315257,0,0,9262518,19363360,0,0,0,0,0,425536,19788896,29051414,0,847544,0,423751,517712,1789007,0,0,0,0,0,613041,613041,2402048,0,0
50050,Indianapolis and Marion County Public Transportation,Full Reporter,Urban,88821895,4851983,3226578,360022,52019807,0,149280285,316309080,0,0,0,51497613,0,17870959,385677652,534957937,0,5910585,4163199,1751849,284606,12110239,38995634,0,0,239547,0,1231835,40467016,52577255,3539632,0
50051,Greater Lafayette Public Transportation Corporation,Full Reporter,Urban,5015801,1848594,494197,161314,0,0,7519906,27443504,0,0,1557188,1776628,0,0,30777320,38297226,1295817,331685,11693,534515,20568,898461,51985,0,0,1524278,0,0,1576263,2474724,2507303,34611016
50052,South Bend Public Transportation Corporation,Full Reporter,Urban,965092,875640,431671,8147,600798,0,2881348,31586403,0,0,0,81489,0,0,31667892,34549240,416492,67649,0,0,547852,615501,0,0,0,46080,0,0,46080,661581,1551165,32752986
50054,Muncie Indiana Transit System,Full Reporter,Urban,1540606,9154,376014,97240,0,0,2023014,8366132,0,0,0,0,0,0,8366132,10389146,373362,80425,0,47736,0,128161,0,0,9127,818194,0,0,827321,955482,1735399,8071627
50056,Greater Peoria Mass Transit District,Full Reporter,Urban,36178775,15430133,541441,897504,426643,0,53474496,19948463,0,0,0,0,0,0,19948463,73422959,7361374,7808728,0,2572568,0,10381296,0,0,0,1154402,18006806,0,19161208,29542504,4617559,46624270
50057,Rock Island County Metropolitan Mass Transit District,Full Reporter,Urban,4786133,4289084,18493,799601,0,0,9893311,77083453,0,0,0,0,0,0,77083453,86976764,2076372,503288,0,622298,1662289,2787875,0,0,984164,312441,99985,58960,1455550,4243425,1938154,82871557
50058,Rockford Mass Transit District,Full Reporter,Urban,4510104,5772015,424627,44697,0,0,10751443,28885448,0,0,0,0,0,0,28885448,39636891,1113816,195965,0,2951934,0,3147899,0,0,0,1561879,0,4963952,6525831,9673730,2693707,28383270
50059,Springfield Mass Transit District,Full Reporter,Urban,5159760,2993608,677696,140730,0,293873,9265667,29171758,0,0,4170565,1436717,603621,0,35382661,44648328,1324878,1889398,0,971234,0,2860632,468852,0,0,0,0,10682273,11151125,14011757,4428669,27532780
50060,Champaign-Urbana Mass Transit District,Full Reporter,Urban,22434710,15025507,1510603,1273535,2231399,0,42475754,64729595,131123,0,20524577,11931214,0,0,97316509,139792263,3341628,4404593,2626345,4454215,1726651,13211804,0,0,0,6161726,264205,0,6425931,19637735,9646643,113849513
50066,Chicago Transit Authority,Full Reporter,Urban,166670046,488424525,27537865,6210594,0,0,688843030,4401317445,0,0,488162437,723097370,44959279,0,5657536531,6346379561,244271215,256957182,276378101,235536801,223667661,992539745,4450341759,0,53730603,1873860822,212551805,20000,6590504989,7583044734,10615116,-1003009074
50104,Northern Indiana Commuter Transportation District,Full Reporter,Urban,19534498,42814516,6803920,3328520,3395612,0,75877066,280162973,0,0,56365376,352317818,210535,0,689056702,764933768,636692,27553428,2475000,6949377,1061369,38039174,84140103,0,12798,1171012,0,0,85323913,123363087,646738,641560635
50110,Bloomington Public Transportation Corporation,Full Reporter,Urban,10675047,203571,349493,42604,0,838026,12108741,17739347,0,0,0,223525,0,0,17962872,30071613,647117,75889,0,453188,0,529077,0,0,0,768718,0,0,768718,1297795,1302626,28118309
50113,Pace - Suburban Bus Division,Full Reporter,Urban,25415527,188161823,9286068,4674942,49038818,6369277,282946455,288967729,0,0,482696,39437712,0,0,328888137,611834592,39203472,10827630,1200000,16134945,2696775,30859350,2400000,294658,0,46841185,36533068,28380136,114449047,145308397,9709346,496020321
50117,Laketran,Full Reporter,Urban,11828366,23144401,696131,0,19784214,0,55453112,40976407,0,0,525141,855818,0,1077210,43434576,98887688,2880693,188365,0,1573089,0,1761454,0,511622,0,8206940,0,0,8718562,10480016,16981005,74307360
50118,Northeast Illinois Regional Commuter Railroad Corporation,Full Reporter,Urban,47014871,252034453,27589461,11148290,229894685,0,567681760,3115091482,0,0,0,142491181,29528650,0,3287111313,3854793073,68359718,5332854,0,215263033,0,220595887,0,0,0,62730929,123142848,0,185873777,406469664,14900571,3501782556
50141,Detroit Transportation Corporation,Full Reporter,Urban,941000,4675833,3268033,623372,4685,0,9512923,23913093,0,0,1198191,1332299,4610479,0,31054062,40566985,1501995,577606,1920,229362,7731077,8539965,580940,0,0,4832211,0,0,5413151,13953116,4580434,23535430
50146,Madison County Transit District,Full Reporter,Urban,11408,7415027,932847,928155,31312214,0,40599651,64602172,0,0,0,0,22900000,0,87502172,128101823,0,3337815,0,0,0,3337815,0,0,0,0,0,0,0,3337815,0,0
50148,Blue Water Area Transportation Commission,Full Reporter,Urban,11007626,2149794,788991,320721,0,0,14267132,25605772,0,0,0,513870,0,0,26119642,40386774,1366520,594965,0,436899,245037,1276901,0,0,0,2871374,0,277975,3149349,4426250,459974,36867070
50157,Butler County Regional Transit Authority,Full Reporter,Urban,4114328,1954762,45290,155077,0,0,6269457,7485715,0,0,0,972651,0,384854,8843220,15112677,741410,382537,0,317436,102480,802453,0,0,0,2837919,0,0,2837919,3640372,2492030,9721685
50182,"Pace-Suburban Bus Division, ADA Paratransit Services",Full Reporter,Urban,12644099,14565686,0,6369102,0,0,33578887,874471,0,0,0,0,0,0,874471,34453358,2913462,494752,0,24635643,7616942,32747337,0,315,0,3075195,167963,0,3243473,35990810,501539,874471
50184,Macatawa Area Express Transportation Authority,Full Reporter,Urban,4372124,269545,0,91275,0,0,4732944,8338563,0,0,0,0,0,0,8338563,13071507,0,179854,0,263595,6243,449692,1417847,0,0,0,0,0,1417847,1867539,0,0
50199,Delaware County Transit Board,Full Reporter,Urban,4548573,323119,0,39642,0,0,4911334,5782585,0,0,0,0,0,48039,5830624,10741958,537305,48039,0,163289,34318,245646,0,1489075,0,0,0,0,1489075,1734721,1230730,8313812
50204,Jackson County Mass Transit District,Full Reporter,Urban,572281,215342,0,96259,0,0,883882,500412,0,0,0,0,0,0,500412,1384294,0,83343,0,90793,311957,486093,0,0,0,0,0,0,0,486093,0,0
50209,Central Indiana Regional Transportation Authority ,Full Reporter,Urban,280554,0,0,0,0,0,280554,0,0,0,0,0,0,0,0,280554,0,0,0,0,0,0,0,0,0,0,0,0,0,0,0,0
50211,Rides Mass Transit District,Full Reporter,Urban,355140,3107790,0,1063598,0,0,4526528,12958740,0,0,0,0,0,0,12958740,17485268,0,476788,0,0,1974621,2451409,0,0,0,0,0,0,0,2451409,0,0
50212,Stateline Mass Transit District,Separate Service,Urban,68739,790626,0,0,0,0,859365,186018,0,0,0,0,0,0,186018,1045383,0,22642,0,0,0,22642,0,0,0,0,0,0,0,22642,0,0
50518,SouthWest Transit,Full Reporter,Urban,8018397,1160063,232927,149798,0,0,9561185,41622253,0,0,10732054,0,0,0,52354307,61915492,882978,572703,0,92191,212010,876904,0,37414,0,1195725,0,138082,1371221,2248125,1326920,59223425
50519,Minnesota Valley Transit Authority,Full Reporter,Urban,18318497,64480,48473,499078,1995800,0,20926328,51337338,0,0,0,0,0,0,51337338,72263666,933805,4823778,20076,113045,63614,5020513,2420000,0,3140,1157291,0,295032,3875463,8895976,1066020,63235475
50522,Lake Erie Transportation Commission,Full Reporter,Urban,1697674,2669,339679,120451,0,4049613,6210086,235886,0,0,0,0,1785199,0,2021085,8231171,0,62613,64517,74551,594256,795937,0,5401,0,0,0,0,5401,801338,0,0
60007,Fort Worth Transportation Authority,Full Reporter,Urban,29375874,28475156,8142607,3502076,0,0,69495713,1112534142,17668967,0,0,24277702,0,0,1154480811,1223976524,0,19735254,164299,1501036,2711146,24111735,0,0,0,0,0,29982357,29982357,54094092,0,1169882432
60008,"Metropolitan Transit Authority of Harris County, Texas ",Full Reporter,Urban,8824981,463065492,42378938,0,605405807,7127948,1126803166,2571936226,0,0,105616879,106483806,0,3816504,2787853415,3914656581,182072550,61529323,65305000,53669442,18514317,199018082,1101707854,0,0,966140436,0,9285475,2077133765,2276151847,112253465,1708323819
60011,VIA Metropolitan Transit,Full Reporter,Urban,282221375,129204499,6435404,36728,18554990,0,436452996,324380406,0,0,2701667,55627376,0,0,382709449,819162445,49337235,29227887,9090000,8306743,8182422,54807052,138916604,0,0,189408819,0,0,328325423,383132475,12972367,472394838
60022,Capital Area Transit System,Full Reporter,Urban,5959266,20679452,706371,179983,0,0,27525072,20077160,0,0,0,0,0,0,20077160,47602232,1164137,2617999,623092,757284,889303,4887678,0,0,962006,0,722260,0,1684266,6571944,0,0
60032,New Orleans Regional Transit Authority,Full Reporter,Urban,41999246,45785741,718992,3444807,4003369,0,95952155,267047280,0,0,0,20681876,12470227,19232296,319431679,415383834,927856,6306379,5554130,2724031,28579445,43163985,17940705,0,0,6890440,0,0,24831145,67995130,21458318,326858242
60033,Rock Region Metropolitan Transit Authority,Full Reporter,Urban,4481275,138213,451788,113638,0,0,5184914,40841361,0,0,0,0,0,0,40841361,46026275,0,404012,0,1093594,6525,1504131,0,0,0,0,0,0,0,1504131,0,0
60048,Capital Metropolitan Transportation Authority,Full Reporter,Urban,160738049,72491780,3345374,2972675,21634630,59708832,320891340,448380905,0,0,0,38216729,46836740,0,533434374,854325714,12935298,32687543,0,27233170,547037,60467750,0,0,576638,48932919,0,8911376,58420933,118888683,16623532,731748797
60051,Corpus Christi Regional Transportation Authority,Full Reporter,Urban,49306194,7563619,1019062,410275,0,0,58299150,69911356,0,0,0,356089,0,941537,71208982,129508132,4508711,750211,890000,5778289,346085,7764585,17690000,0,0,0,0,2296110,19986110,27750695,4798527,101467621
60056,Dallas Area Rapid Transit,Full Reporter,Urban,314743692,158020469,35454114,5578117,352290921,17706,866105019,3561300843,0,0,943638,658168497,121159355,18506537,4360078870,5226183889,98137527,96084668,236408848,0,99631536,432125052,3212854435,44050347,121159355,38283000,0,0,3416347137,3848472189,25670842,1450178385
60059,Brazos Transit District,Full Reporter,Urban,4306649,133671,51733,0,0,0,4492053,45124221,0,0,0,0,0,0,45124221,49616274,463980,0,0,451219,0,451219,0,0,0,0,0,0,0,451219,0,0
60091,Hill Country Transit District,Full Reporter,Urban,4972711,807872,330072,0,0,0,6110655,10511664,0,0,0,0,0,0,10511664,16622319,0,66465,0,4859,0,71324,0,0,0,0,0,251327,251327,322651,0,0
60101,Denton County Transportation Authority,Full Reporter,Urban,59281188,10848223,719857,456625,9537185,0,80843078,285070269,17394147,0,0,2765189,0,697723,305927328,386770406,421130,2076050,2565000,1135861,53100,5830011,18800000,0,0,65492,0,700000,19565492,25395503,152490,361643543
60102,Concho Valley Transit District,Full Reporter,Urban,614051,825689,0,0,0,0,1439740,11190303,0,0,79519,0,0,0,11269822,12709562,0,123248,0,0,0,123248,0,0,0,0,0,0,0,123248,175695,0
60111,Rio Metro Regional Transit District,Full Reporter,Urban,29736504,18625205,0,109000,0,0,48470709,2171937,0,0,0,0,0,150000,2321937,50792646,0,11494884,0,0,0,11494884,10222851,0,0,0,0,0,10222851,21717735,0,0
70002,Transit Authority of Omaha,Full Reporter,Urban,8103311,28992151,1245383,928694,0,0,39269539,67680250,0,0,81529,0,0,0,67761779,107031318,4259832,2272365,0,1596213,0,3868578,0,0,0,11258384,1540736,0,12799120,16667698,6894834,87728618
70005,Kansas City Area Transportation Authority,Full Reporter,Urban,8943786,4075600,1801520,941020,815000,0,16576926,136783188,0,0,37564734,0,0,754470,175102392,191679318,7073308,3057307,0,5975175,2449021,11481503,0,0,0,16812903,3346292,0,20159195,31640698,24556114,142555814
70006,Bi-State Development Agency of the Missouri-Illinois Metropolitan District,Full Reporter,Urban,151810783,50041064,10850223,4981318,40123928,0,257807316,780531091,0,0,0,48758448,173650745,126950,1003067234,1260874550,37117531,16616557,12230000,23204950,4686252,56737759,506550268,0,134066864,93552468,0,31521960,765691560,822429319,55297049,420265713
70010,Des Moines Area Regional Transit Authority,Full Reporter,Urban,15697872,30377492,836448,1367437,0,0,48279249,52874939,0,0,0,1012837,0,0,53887776,102167025,4628720,1057200,707109,1825412,1462308,5052029,0,0,4540908,13741382,0,0,18282290,23334319,25721663,57739763
70014,Topeka Metropolitan Transit Authority,Full Reporter,Urban,6248968,177464,47305,266023,0,0,6739760,12091929,0,0,11004216,416111,0,0,23512256,30252016,773871,93174,0,392630,435700,921504,0,0,0,3844898,0,1591050,5435948,6357452,2192990,22475445
70066,Heart of Iowa Regional Transit Agency,Full Reporter,Urban,2106641,507986,0,0,0,0,2614627,1793427,0,0,0,0,0,0,1793427,4408054,351396,70777,0,0,29089,99866,0,0,0,1283311,0,15894,1299205,1399071,300532,3059847
80001,Utah Transit Authority,Full Reporter,Urban,190968233,127657405,34175227,2245414,168610773,0,523657052,2626933741,57097309,0,0,203927118,113933935,30542240,3032434343,3556091395,131746061,45649680,64946585,11994316,59258107,181848688,2290282547,56125000,0,90642486,0,18313945,2455363978,2637212666,24204207,1026420583
80006,Denver Regional Transportation District,Full Reporter,Urban,760614000,202808000,34692000,9952000,18833000,1655000,1028554000,6165909000,0,0,0,115696000,276612000,0,6558217000,7586771000,54203000,54402000,71548000,42324000,15484000,183758000,3139742000,0,0,260200000,0,558253000,3958195000,4141953000,36223000,3462798000
80009,Missoula Urban Transportation District,Full Reporter,Urban,17548891,4408076,269183,30537,0,0,22256687,11233243,0,0,0,0,0,0,11233243,33489930,0,2153830,0,289107,39700,2482637,0,0,0,0,0,465286,465286,2947923,0,0
80012,Great Falls Transit District,Full Reporter,Urban,7608958,366275,110398,314237,0,0,8399868,3740502,0,0,17500,0,0,0,3758002,12157870,0,320266,0,308585,9600,638451,0,0,0,0,0,0,0,638451,0,0
80028,Cache Valley Transit District,Full Reporter,Urban,13208111,1646014,73000,4856,0,0,14931981,14349444,0,0,0,0,0,0,14349444,29281425,0,259034,0,125563,290000,674597,0,0,0,0,0,165000,165000,839597,0,0
90001,Regional Transportation Commission of Washoe County,Full Reporter,Urban,37525307,17615291,168079,329351,0,3656763,59294791,101850913,0,0,0,0,0,0,101850913,161145704,0,7993104,0,0,3028605,11021709,0,3883166,0,8379581,0,0,12262747,23284456,0,0
90003,San Francisco Bay Area Rapid Transit District,Full Reporter,Urban,531614054,219964725,70753004,17939023,147350077,2333718,989954601,7888355805,0,0,863856530,1979176998,0,13672309,10745061642,11735016243,215592508,204879273,65825000,110782050,35148807,416635130,2742914216,103289707,0,1072905197,72338385,40510754,4031958259,4448593389,148393544,7353621818
90004,Golden Empire Transit District,Full Reporter,Urban,22220694,1779129,1076750,122477,0,0,25199050,36614588,0,0,0,0,0,0,36614588,61813638,0,1922330,0,2329813,0,4252143,0,0,0,0,6132885,9040992,15173877,19426020,0,0
90006,Santa Cruz Metropolitan Transit District,Full Reporter,Urban,43406546,6184065,774184,821318,0,11336333,62522446,81057482,0,0,12953070,5191107,0,0,99201659,161724105,19835043,2571998,0,5043968,501049,8117015,0,14144872,659825,196573845,1923778,40311,213342631,221459646,3493401,-43393899
90009,San Mateo County Transit District,Full Reporter,Urban,148485618,72045962,1663107,1454058,43937973,29310,267616028,165552919,0,0,0,6416125,154436852,0,326405896,594021924,21480806,9872945,10780000,17223022,20350171,58226138,181705428,0,0,105453145,14614970,0,301773543,359999681,3325810,252177239
90012,San Joaquin Regional Transit District,Full Reporter,Urban,22775621,19074521,1005344,821406,0,3656,43680548,112229565,0,0,5344284,12133,0,0,117585982,161266530,12130624,4356938,0,2280729,4210337,10848004,7800000,0,0,0,40875000,8777494,57452494,68300498,2090337,103006319
90013,Santa Clara Valley Transportation Authority,Full Reporter,Urban,150146000,127593000,27726000,5518000,737652000,0,1048635000,4177807000,0,0,0,1019068000,0,123475000,5320350000,6368985000,69580000,32780000,16215000,6069000,58663000,113727000,120247000,0,0,279210000,0,0,399457000,513184000,116376000,5809005000
90014,Alameda-Contra Costa Transit District,Full Reporter,Urban,148383231,71842124,14488278,14820383,40017969,0,289551985,305902810,0,0,0,135360367,0,0,441263177,730815162,61614538,8664696,16526675,61301431,1560381,88053183,11655000,0,0,420673738,66030234,0,498358972,586412155,103890014,102127531
90016,"Golden Gate Bridge, Highway and Transportation District",Full Reporter,Urban,6270,8176912,4428859,629808,0,0,13241849,188057503,0,0,0,69323964,0,0,257381467,270623316,6493879,4550467,0,5467244,6304100,16321811,512753,0,0,97108000,16303298,0,113924051,130245862,16129000,130742333
90019,Sacramento Regional Transit District,Full Reporter,Urban,36143649,24941898,23919052,1029909,17502056,0,103536564,780637203,0,0,59483560,51363202,23175802,0,914659767,1018196331,57283557,10430208,1270000,20449292,2040012,34189512,46972667,0,49767388,154896431,14910987,18214153,284761626,318951138,11264972,745263778
90020,Santa Barbara Metropolitan Transit District,Full Reporter,Urban,13618202,5152914,828980,322052,0,0,19922148,34844459,1517447,0,1936203,559203,0,0,38857312,58779460,353733,505293,0,1476600,1401976,3383869,0,751798,1380001,1554885,3697929,1936203,9320816,12704685,55726,46372782
90023,Long Beach Transit,Full Reporter,Urban,52615290,8106419,2716574,1148554,0,0,64586837,94445783,0,0,0,1914731,22890271,0,119250785,183837622,7325749,4194836,1124341,981869,65508072,71809118,3628038,0,0,13865718,4720485,8470897,30685138,102494256,15418522,73250593
90026,San Diego Metropolitan Transit System,Full Reporter,Urban,38885696,2803143,29316441,1696850,0,0,72702130,1742720572,0,0,0,0,0,0,1742720572,1815422702,50879481,18450342,2835000,10294151,1421575,33001068,4830000,0,0,234159689,15782524,0,254772213,287773281,7057165,1571471737
90029,Omnitrans,Full Reporter,Urban,22707290,39124530,3267553,700566,0,0,65799939,171351733,0,0,0,23500916,73643754,0,268496403,334296342,9484426,24256682,0,1523425,5783052,31563159,0,10285743,0,34538498,0,66266546,111090787,142653946,1467468,199659354
90030,North County Transit District,Full Reporter,Urban,82643347,29211507,4195327,2696031,0,0,118746212,717893917,0,0,8802845,71005786,0,0,797702548,916448760,8602326,19797798,1300000,2334994,30683221,54116013,20450000,0,0,47719633,1683961,20246936,90100530,144216543,206533,780628010
90031,Riverside Transit Agency,Full Reporter,Urban,56330016,6200786,902090,324435,0,0,63757327,79468935,0,0,0,0,0,11079388,90548323,154305650,7388055,5744949,0,8271217,39918184,53934350,0,0,0,165396,0,0,165396,54099746,3681889,103912070
90035,Gold Coast Transit District,Full Reporter,Urban,6933108,4961510,582976,0,0,0,12477594,63351016,0,0,16112568,0,0,37374,79500958,91978552,0,371094,0,1694253,882059,2947406,21948793,0,0,13969412,0,6827936,42746141,45693547,1954,0
90036,Orange County Transportation Authority,Full Reporter,Urban,597828221,36942082,4322860,23023284,0,0,662116447,236202433,0,0,16762722,3149236,0,0,256114391,918230838,22254000,27257988,7649084,5898566,19668572,60474210,0,0,0,138073344,0,1113941,139187285,199661495,43885000,696938343
90045,Regional Transportation Commission of Southern Nevada,Full Reporter,Urban,35433554,156534014,0,394997,623023697,0,815386262,423304156,0,0,0,0,0,0,423304156,1238690418,25716128,87526938,50859102,17918976,310842,156615858,785416369,0,0,53190946,20600515,0,859207830,1015823688,10761263,237821595
90061,Yuba-Sutter Transit Authority,Full Reporter,Urban,5450288,1046207,0,37421,0,0,6533916,14660864,0,0,0,17008,0,0,14677872,21211788,323556,625634,0,47935,3019036,3692605,0,0,0,135900,0,25050,160950,3853555,237708,17444081
90062,Monterey-Salinas Transit,Full Reporter,Urban,25575987,15527604,367571,596744,0,0,42067906,56004783,0,0,0,15259707,0,8825,71273315,113341221,3200667,4369560,850726,2596350,2744711,10561347,3863463,0,0,15646625,1564528,0,21074616,31635963,1119688,83786237
90078,Central Contra Costa Transit Authority,Full Reporter,Urban,20320806,4302648,879224,221338,0,0,25724016,40643039,0,0,0,353917,0,0,40996956,66720972,3741675,2597511,0,3100767,17287370,22985648,0,0,0,11917849,0,4165033,16082882,39068530,2225521,29168596
90079,SunLine Transit Agency,Full Reporter,Urban,3857216,13376553,1172708,866945,0,9962294,29235716,56865433,0,0,0,29770482,0,0,86635915,115871631,5428031,3190412,0,360332,13976651,17527395,2919147,0,0,0,0,0,2919147,20446542,3770701,97082419
90088,Napa Valley Transportation Authority,Full Reporter,Urban,1820585,1724619,227396,55051,2075357,0,5903008,19430818,0,0,0,0,0,0,19430818,25333826,0,1144712,0,2222987,599354,3967053,0,0,0,0,0,0,0,3967053,0,0
90090,Yolo County Transportation District,Full Reporter,Urban,6336703,5150474,0,0,0,0,11487177,25979190,0,0,1542235,0,0,0,27521425,39008602,474046,1262049,0,1115595,0,2377644,0,0,0,1105781,0,0,1105781,3483425,193195,35806028
90093,Redding Area Bus Authority,Full Reporter,Urban,3382122,16538,82370,0,581089,0,4062119,11992600,0,0,0,0,0,0,11992600,16054719,0,1442281,1818889,16578,3000,3280748,0,0,0,0,0,0,0,3280748,0,0
90121,Antelope Valley Transit Authority,Full Reporter,Urban,27540695,4284541,516410,217268,0,0,32558914,72403604,0,0,0,4384052,0,0,76787656,109346570,717467,3199416,0,76944,0,3276360,0,0,0,1441859,0,579318,2021177,5297537,10284,104756216
90134,Peninsula Corridor Joint Powers Board,Full Reporter,Urban,96072436,212803278,8109708,840000,4438238,0,322263660,858226187,0,0,0,1840831246,0,0,2699057433,3021321093,0,126472107,60300000,1683454,60371133,248826694,53506092,0,0,0,0,2346881,55852973,304679667,1345588,0
90136,Regional Public Transportation Authority,Full Reporter,Urban,54397223,58081353,0,139870,26146094,10835000,149599540,111144025,0,0,3913715,4460333,15491740,158265,135168078,284767618,9231674,85075289,22844956,3226969,650263,111797477,88882230,0,0,38339054,0,572317,127793601,239591078,664572,53743642
90144,Livermore / Amador Valley Transit Authority,Full Reporter,Urban,21415414,4062932,0,156477,0,3962876,29597699,26022769,0,0,0,29934373,0,0,55957142,85554841,833535,1785702,0,41169,0,1826871,0,26989566,0,1333048,341502,818350,29482466,31309337,260592,54818447
90146,Foothill Transit,Full Reporter,Urban,24457330,16919273,0,1448968,0,0,42825571,237403502,0,0,0,0,96428402,585800,334417704,377243275,0,23656048,0,0,24457330,48113378,0,0,0,0,0,48141061,48141061,96254439,0,0
90148,Victor Valley Transit Authority,Full Reporter,Urban,22938411,5292286,0,825995,0,0,29056692,82335383,0,0,0,0,0,0,82335383,111392075,1314655,1901522,878593,2441339,4001337,9222791,30960236,0,0,0,265608,0,31225844,40448635,1894,72256201
90151,Southern California Regional Rail Authority,Full Reporter,Urban,100231475,78530630,18599709,581895,0,0,197943709,1385695030,0,0,0,0,117067183,325612,1503087825,1701031534,8802582,43853274,0,31616906,179090186,254560366,0,6869669,292629,15841157,0,13650000,36653455,291213821,6078233,1412542062
90154,Los Angeles County Metropolitan Transportation Authority ,Full Reporter,Urban,15156425,179205184,81912242,8014265,199371568,9757215,493416899,8632320916,0,0,1074653205,9170338829,421844871,12384695,19311542516,19804959415,352452259,309097031,334004733,309560090,183174807,1135836661,6382017337,0,0,1796521062,350443715,51972369,8580954483,9716791144,431166400,10009454130
90157,Access Services  ,Full Reporter,Urban,20140243,5626651,0,0,0,7578898,33345792,12298046,0,0,0,0,0,10558575,22856621,56202413,0,13386588,0,8791064,19234303,41411955,0,0,0,0,0,0,0,41411955,0,0
90159,Western Contra Costa Transit Authority,Full Reporter,Urban,3119973,1329163,0,35506,0,0,4484642,16050974,0,0,0,0,0,0,16050974,20535616,275635,626609,0,37195,3747713,4411517,0,0,0,690555,0,73125,763680,5175197,19917,15616137
90162,The Eastern Contra Costa Transit Authority,Full Reporter,Urban,7516854,1892734,690585,0,788263,0,10888436,28529175,0,0,0,0,0,6148,28535323,39423759,0,7331760,81899,452696,834194,8700549,1049703,0,0,0,66067,0,1115770,9816319,0,0
90164,Ventura County Transportation Commission,Full Reporter,Urban,1616114,712613,0,0,0,0,2328727,11205750,0,0,0,0,0,0,11205750,13534477,154870,893062,0,662170,587844,2143076,0,0,0,191349,0,26566,217915,2360991,21835,11306521
90173,Transit Joint Powers Authority for Merced County,Full Reporter,Urban,8194767,338716,0,0,0,36429262,44962745,15852681,0,0,0,0,0,0,15852681,60815426,0,5003072,0,0,9801675,14804747,0,0,0,0,0,0,0,14804747,0,0
90182,Altamont Corridor Express,Full Reporter,Urban,49596797,20572875,1934419,3724461,0,0,75828552,265553840,0,0,1795713,0,0,0,267349553,343178105,0,5904309,1966957,25635030,0,33506296,41266606,0,0,0,0,159422,41426028,74932324,0,0
90200,Kings County Area Public Transit Agency,Full Reporter,Urban,4502233,2588417,0,212,0,0,7090862,13933396,0,0,629584,783954,0,0,15346934,22437796,103175,271606,355074,0,3938248,4564928,0,0,1667,0,0,0,1667,4566595,44,17974332
90206,San Luis Obispo Regional Transit Authority,Full Reporter,Urban,6643804,1991410,225134,82008,0,2000,8944356,26408400,0,0,0,0,0,0,26408400,35352756,2708863,1957094,0,250801,8626635,10834530,3700697,0,0,3072225,38650,843573,7655145,18489675,311560,19260384
90209,"Valley Metro Rail, Inc.",Full Reporter,Urban,18715459,145444247,18508607,1091555,0,8432,183768300,1265814035,0,0,4990487,713605330,0,0,1984409852,2168178152,0,97444307,10835000,9681244,63453747,181414298,3913715,3086585,0,0,921644,0,7921944,189336242,0,0
90211,Anaheim Transportation Network,Full Reporter,Urban,5150328,15263866,128793,141113,0,61758,20745858,25180337,0,0,0,0,0,0,25180337,45926195,0,18057614,272304,95024,0,18424942,2651239,0,0,0,0,0,2651239,21076181,0,0
90219,Northern Arizona Intergovernmental Public Transportation Authority,Full Reporter,Urban,1312404,1632422,323681,73687,0,0,3342194,28048744,0,0,0,1696643,0,0,29745387,33087581,729993,614932,0,874373,9167,1498472,0,0,0,6664388,0,683827,7348215,8846687,107670,24863217
90223,"Paratransit, Inc.",Full Reporter,Urban,3829738,1638852,94923,496389,0,0,6059902,7881369,0,0,301229,0,0,0,8182598,14242500,0,297260,2742218,152007,55752,3247237,2907722,0,0,0,0,0,2907722,6154959,0,0
90225,San Francisco Bay Area Water Emergency Transportation Authority,Full Reporter,Urban,31622057,5125838,93215,5297684,0,0,42138794,408189282,2861500,0,0,26128888,0,0,437179670,479318464,1862606,3757690,0,1231376,4000,4993066,0,11670743,0,0,0,0,11670743,16663809,516422,464000839
90226,Imperial County Transportation Commission,Full Reporter,Urban,18001918,279345,0,0,0,0,18281263,5288829,0,0,0,0,0,0,5288829,23570092,0,0,0,0,1114153,1114153,0,0,0,0,0,0,0,1114153,0,0
90230,California Vanpool Authority,Full Reporter,Urban,1189710,1436264,5579178,1039,332143,100,8538434,110834,0,0,0,0,0,0,110834,8649268,220504,745944,4349,0,0,750293,2273897,0,0,0,0,0,2273897,3024190,50455,5795127
90232,Solano County Transit,Full Reporter,Urban,2385755,1775885,118957,164098,8070291,0,12514986,44217324,0,0,0,1332657,0,0,45549981,58064967,144671,1234681,0,152381,11466168,12853230,0,0,0,0,0,0,0,12853230,16398,45340010
90233,Yuma County Intergovernmental Public Transportation Authority,Full Reporter,Urban,237287,1333271,0,0,0,0,1570558,7393507,0,0,0,0,0,0,7393507,8964065,77759,764174,0,0,1609723,2373897,0,0,0,526726,0,0,526726,2900623,52728,6088473
90234,Marin County Transit District,Full Reporter,Urban,25892365,12153513,8013,2975544,0,0,41029435,40221268,0,0,0,673963,0,0,40895231,81924666,6088,2919713,0,0,1306230,4225943,0,0,0,0,0,22759,22759,4248702,0,0
90299,Sonoma-Marin Area Rail Transit District,Full Reporter,Urban,27033511,26851189,1619411,2083370,41932508,883300,100403289,527918764,216320,0,0,25987692,0,0,554122776,654526065,3312099,1931099,13832252,931737,2357801,19052889,106434517,0,0,5971917,0,258665,112665099,131717988,189390,525930786
91092,Tahoe Transportation District,Full Reporter,Urban,2360379,1480542,362560,16305,0,0,4219786,1958573,0,0,0,41489,0,0,2000062,6219848,0,396485,0,28954,0,425439,128237,0,0,0,0,0,128237,553676,0,0
99425,Pomona Valley Transportation Authority,Full Reporter,Urban,4555473,0,0,0,0,607549,5163022,607549,0,0,0,0,0,0,607549,5770571,0,0,0,0,0,0,0,0,0,0,2280367,0,2280367,2280367,0,0
